Date,Week,Day,Time,Winner,Awaygame,Loser,PtsW,PtsL,YdsW,TOW,YdsL,TOL,Tie,PointDiff,YardDiff,TurnoverDiff,Home,Away
2017-09-07,1,Thu,8:30PM,Kansas City Chiefs,@,New England Patriots,42,27,537,1,371,0,0,15,166,1,False,True
2017-09-10,1,Sun,8:30PM,Dallas Cowboys,,New York Giants,19,3,392,0,233,1,0,16,159,-1,True,False
2017-09-10,1,Sun,4:25PM,Green Bay Packers,,Seattle Seahawks,17,9,370,1,225,1,0,8,145,0,True,False
2017-09-10,1,Sun,4:25PM,Carolina Panthers,@,San Francisco 49ers,23,3,287,2,217,2,0,20,70,0,False,True
2017-09-10,1,Sun,4:05PM,Los Angeles Rams,,Indianapolis Colts,46,9,373,1,225,3,0,37,148,-2,True,False
2017-09-10,1,Sun,1:00PM,Philadelphia Eagles,@,Washington Commanders,30,17,356,2,264,4,0,13,92,-2,False,True
2017-09-10,1,Sun,1:00PM,Atlanta Falcons,@,Chicago Bears,23,17,372,0,301,0,0,6,71,0,False,True
2017-09-10,1,Sun,1:00PM,Jacksonville Jaguars,@,Houston Texans,29,7,280,0,203,4,0,22,77,-4,False,True
2017-09-10,1,Sun,1:00PM,Buffalo Bills,,New York Jets,21,12,408,1,214,2,0,9,194,-1,True,False
2017-09-10,1,Sun,1:00PM,Baltimore Ravens,@,Cincinnati Bengals,20,0,268,1,221,5,0,20,47,-4,False,True
2017-09-10,1,Sun,1:00PM,Las Vegas Raiders,@,Tennessee Titans,26,16,359,0,350,0,0,10,9,0,False,True
2017-09-10,1,Sun,1:00PM,Detroit Lions,,Arizona Cardinals,35,23,367,1,308,4,0,12,59,-3,True,False
2017-09-10,1,Sun,1:00PM,Pittsburgh Steelers,@,Cleveland Browns,21,18,290,1,237,1,0,3,53,0,False,True
2017-09-11,1,Mon,7:10PM,Minnesota Vikings,,New Orleans Saints,29,19,470,0,344,0,0,10,126,0,True,False
2017-09-11,1,Mon,10:20PM,Denver Broncos,,Los Angeles Chargers,24,21,321,2,249,1,0,3,72,1,True,False
2017-09-14,2,Thu,8:25PM,Houston Texans,@,Cincinnati Bengals,13,9,266,0,295,1,0,4,-29,-1,False,True
2017-09-17,2,Sun,8:30PM,Atlanta Falcons,,Green Bay Packers,34,23,364,0,367,2,0,11,-3,-2,True,False
2017-09-17,2,Sun,4:25PM,Seattle Seahawks,,San Francisco 49ers,12,9,312,0,248,1,0,3,64,-1,True,False
2017-09-17,2,Sun,4:25PM,Washington Commanders,@,Los Angeles Rams,27,20,385,0,332,2,0,7,53,-2,False,True
2017-09-17,2,Sun,4:25PM,Denver Broncos,,Dallas Cowboys,42,17,380,2,268,2,0,25,112,0,True,False
2017-09-17,2,Sun,4:05PM,Las Vegas Raiders,,New York Jets,45,20,410,0,271,2,0,25,139,-2,True,False
2017-09-17,2,Sun,4:05PM,Miami Dolphins,@,Los Angeles Chargers,19,17,336,0,367,0,0,2,-31,0,False,True
2017-09-17,2,Sun,1:00PM,Kansas City Chiefs,,Philadelphia Eagles,27,20,344,0,406,2,0,7,-62,-2,True,False
2017-09-17,2,Sun,1:00PM,Pittsburgh Steelers,,Minnesota Vikings,26,9,335,0,237,1,0,17,98,-1,True,False
2017-09-17,2,Sun,1:00PM,Tennessee Titans,@,Jacksonville Jaguars,37,16,390,1,310,3,0,21,80,-2,False,True
2017-09-17,2,Sun,1:00PM,Baltimore Ravens,,Cleveland Browns,24,10,337,2,386,5,0,14,-49,-3,True,False
2017-09-17,2,Sun,1:00PM,Tampa Bay Buccaneers,,Chicago Bears,29,7,311,1,310,4,0,22,1,-3,True,False
2017-09-17,2,Sun,1:00PM,Carolina Panthers,,Buffalo Bills,9,3,255,0,176,0,0,6,79,0,True,False
2017-09-17,2,Sun,1:00PM,New England Patriots,@,New Orleans Saints,36,20,555,0,429,0,0,16,126,0,False,True
2017-09-17,2,Sun,1:00PM,Arizona Cardinals,@,Indianapolis Colts,16,13,389,1,266,1,0,3,123,0,False,True
2017-09-18,2,Mon,8:30PM,Detroit Lions,@,New York Giants,24,10,257,1,270,1,0,14,-13,0,False,True
2017-09-21,3,Thu,8:25PM,Los Angeles Rams,@,San Francisco 49ers,41,39,418,2,421,2,0,2,-3,0,False,True
2017-09-24,3,Sun,1:00PM,New York Jets,,Miami Dolphins,20,6,336,1,225,2,0,14,111,-1,True,False
2017-09-24,3,Sun,8:30PM,Washington Commanders,,Las Vegas Raiders,27,10,472,2,128,3,0,17,344,-1,True,False
2017-09-24,3,Sun,4:25PM,Kansas City Chiefs,@,Los Angeles Chargers,24,10,311,0,330,3,0,14,-19,-3,False,True
2017-09-24,3,Sun,9:30AM,Jacksonville Jaguars,,Baltimore Ravens,44,7,410,0,186,3,0,37,224,-3,True,False
2017-09-24,3,Sun,4:05PM,Tennessee Titans,,Seattle Seahawks,33,27,420,0,433,0,0,6,-13,0,True,False
2017-09-24,3,Sun,1:00PM,Philadelphia Eagles,,New York Giants,27,24,354,1,415,2,0,3,-61,-1,True,False
2017-09-24,3,Sun,1:00PM,Minnesota Vikings,,Tampa Bay Buccaneers,34,17,494,0,342,3,0,17,152,-3,True,False
2017-09-24,3,Sun,4:25PM,Green Bay Packers,,Cincinnati Bengals,27,24,344,1,301,1,0,3,43,0,True,False
2017-09-24,3,Sun,1:00PM,Indianapolis Colts,,Cleveland Browns,31,28,335,1,346,3,0,3,-11,-2,True,False
2017-09-24,3,Sun,1:00PM,Chicago Bears,,Pittsburgh Steelers,23,17,306,2,282,2,0,6,24,0,True,False
2017-09-24,3,Sun,1:00PM,New Orleans Saints,@,Carolina Panthers,34,13,362,0,288,3,0,21,74,-3,False,True
2017-09-24,3,Sun,1:00PM,Buffalo Bills,,Denver Broncos,26,16,272,0,366,2,0,10,-94,-2,True,False
2017-09-24,3,Sun,1:00PM,Atlanta Falcons,@,Detroit Lions,30,26,428,3,324,0,0,4,104,3,False,True
2017-09-24,3,Sun,1:00PM,New England Patriots,,Houston Texans,36,33,396,1,417,2,0,3,-21,-1,True,False
2017-09-25,3,Mon,8:30PM,Dallas Cowboys,@,Arizona Cardinals,28,17,273,0,332,0,0,11,-59,0,False,True
2017-09-28,4,Thu,8:25PM,Green Bay Packers,,Chicago Bears,35,14,260,0,308,4,0,21,-48,-4,True,False
2017-10-01,4,Sun,8:30PM,Seattle Seahawks,,Indianapolis Colts,46,18,477,2,237,2,0,28,240,0,True,False
2017-10-01,4,Sun,4:25PM,Denver Broncos,,Las Vegas Raiders,16,10,298,0,254,1,0,6,44,-1,True,False
2017-10-01,4,Sun,4:05PM,Philadelphia Eagles,@,Los Angeles Chargers,26,24,454,0,400,1,0,2,54,-1,False,True
2017-10-01,4,Sun,4:05PM,Tampa Bay Buccaneers,,New York Giants,25,23,434,0,379,0,0,2,55,0,True,False
2017-10-01,4,Sun,4:05PM,Arizona Cardinals,,San Francisco 49ers,18,15,368,1,305,1,0,3,63,0,True,False
2017-10-01,4,Sun,1:00PM,New York Jets,,Jacksonville Jaguars,23,20,471,2,311,1,0,3,160,1,True,False
2017-10-01,4,Sun,1:00PM,Pittsburgh Steelers,@,Baltimore Ravens,26,9,381,1,288,3,0,17,93,-2,False,True
2017-10-01,4,Sun,1:00PM,Detroit Lions,@,Minnesota Vikings,14,7,251,0,284,3,0,7,-33,-3,False,True
2017-10-01,4,Sun,1:00PM,Houston Texans,,Tennessee Titans,57,14,445,1,195,5,0,43,250,-4,True,False
2017-10-01,4,Sun,9:30AM,New Orleans Saints,@,Miami Dolphins,20,0,347,0,186,1,0,20,161,-1,False,True
2017-10-01,4,Sun,1:00PM,Buffalo Bills,@,Atlanta Falcons,23,17,281,0,389,3,0,6,-108,-3,False,True
2017-10-01,4,Sun,1:00PM,Los Angeles Rams,@,Dallas Cowboys,35,30,412,0,440,2,0,5,-28,-2,False,True
2017-10-01,4,Sun,1:00PM,Cincinnati Bengals,@,Cleveland Browns,31,7,350,1,215,1,0,24,135,0,False,True
2017-10-01,4,Sun,1:00PM,Carolina Panthers,@,New England Patriots,33,30,444,2,373,0,0,3,71,2,False,True
2017-10-02,4,Mon,8:30PM,Kansas City Chiefs,,Washington Commanders,29,20,429,0,331,1,0,9,98,-1,True,False
2017-10-05,5,Thu,8:25PM,New England Patriots,@,Tampa Bay Buccaneers,19,14,402,2,409,0,0,5,-7,2,False,True
2017-10-08,5,Sun,8:30PM,Kansas City Chiefs,@,Houston Texans,42,34,450,0,392,1,0,8,58,-1,False,True
2017-10-08,5,Sun,4:25PM,Green Bay Packers,@,Dallas Cowboys,35,31,342,1,408,3,0,4,-66,-2,False,True
2017-10-08,5,Sun,4:05PM,Seattle Seahawks,@,Los Angeles Rams,16,10,241,2,375,5,0,6,-134,-3,False,True
2017-10-08,5,Sun,1:00PM,Los Angeles Chargers,@,New York Giants,27,22,382,1,335,2,0,5,47,-1,False,True
2017-10-08,5,Sun,1:00PM,Jacksonville Jaguars,@,Pittsburgh Steelers,30,9,313,1,371,5,0,21,-58,-4,False,True
2017-10-08,5,Sun,4:05PM,Baltimore Ravens,@,Las Vegas Raiders,30,17,365,0,245,1,0,13,120,-1,False,True
2017-10-08,5,Sun,1:00PM,Indianapolis Colts,,San Francisco 49ers,26,23,447,1,402,0,0,3,45,1,True,False
2017-10-08,5,Sun,1:00PM,New York Jets,@,Cleveland Browns,17,14,212,1,419,3,0,3,-207,-2,False,True
2017-10-08,5,Sun,1:00PM,Carolina Panthers,@,Detroit Lions,27,24,362,0,242,1,0,3,120,-1,False,True
2017-10-08,5,Sun,1:00PM,Cincinnati Bengals,,Buffalo Bills,20,16,388,3,221,1,0,4,167,2,True,False
2017-10-08,5,Sun,1:00PM,Miami Dolphins,,Tennessee Titans,16,10,178,2,188,2,0,6,-10,0,True,False
2017-10-08,5,Sun,1:00PM,Philadelphia Eagles,,Arizona Cardinals,34,7,419,1,307,1,0,27,112,0,True,False
2017-10-09,5,Mon,8:30PM,Minnesota Vikings,@,Chicago Bears,20,17,300,0,274,2,0,3,26,-2,False,True
2017-10-12,6,Thu,8:25PM,Philadelphia Eagles,@,Carolina Panthers,28,23,310,1,305,3,0,5,5,-2,False,True
2017-10-15,6,Sun,8:30PM,New York Giants,@,Denver Broncos,23,10,266,0,412,3,0,13,-146,-3,False,True
2017-10-15,6,Sun,4:25PM,Los Angeles Chargers,@,Las Vegas Raiders,17,16,343,1,274,2,0,1,69,-1,False,True
2017-10-15,6,Sun,4:25PM,Pittsburgh Steelers,@,Kansas City Chiefs,19,13,439,1,251,0,0,6,188,1,False,True
2017-10-15,6,Sun,4:05PM,Los Angeles Rams,@,Jacksonville Jaguars,27,17,249,1,389,1,0,10,-140,0,False,True
2017-10-15,6,Sun,4:05PM,Arizona Cardinals,,Tampa Bay Buccaneers,38,33,432,2,412,2,0,5,20,0,True,False
2017-10-15,6,Sun,1:00PM,Minnesota Vikings,,Green Bay Packers,23,10,351,2,227,3,0,13,124,-1,True,False
2017-10-15,6,Sun,1:00PM,New England Patriots,@,New York Jets,24,17,375,2,408,3,0,7,-33,-1,False,True
2017-10-15,6,Sun,1:00PM,Washington Commanders,,San Francisco 49ers,26,24,419,2,335,1,0,2,84,1,True,False
2017-10-15,6,Sun,1:00PM,Miami Dolphins,@,Atlanta Falcons,20,17,289,1,339,1,0,3,-50,0,False,True
2017-10-15,6,Sun,1:00PM,Houston Texans,,Cleveland Browns,33,17,340,1,247,3,0,16,93,-2,True,False
2017-10-15,6,Sun,1:00PM,New Orleans Saints,,Detroit Lions,52,38,379,3,347,5,0,14,32,-2,True,False
2017-10-15,6,Sun,1:00PM,Chicago Bears,@,Baltimore Ravens,27,24,342,2,291,3,0,3,51,-1,False,True
2017-10-16,6,Mon,8:30PM,Tennessee Titans,,Indianapolis Colts,36,22,473,1,297,1,0,14,176,0,True,False
2017-10-19,7,Thu,8:25PM,Las Vegas Raiders,,Kansas City Chiefs,31,30,505,0,425,0,0,1,80,0,True,False
2017-10-22,7,Sun,8:30PM,New England Patriots,,Atlanta Falcons,23,7,403,0,343,0,0,16,60,0,True,False
2017-10-22,7,Sun,1:00PM,Buffalo Bills,,Tampa Bay Buccaneers,30,27,434,1,447,3,0,3,-13,-2,True,False
2017-10-22,7,Sun,1:00PM,Miami Dolphins,,New York Jets,31,28,357,2,272,2,0,3,85,0,True,False
2017-10-22,7,Sun,1:00PM,Jacksonville Jaguars,@,Indianapolis Colts,27,0,518,2,232,0,0,27,286,2,False,True
2017-10-22,7,Sun,1:00PM,Los Angeles Rams,,Arizona Cardinals,33,0,425,1,196,2,0,33,229,-1,True,False
2017-10-22,7,Sun,1:00PM,New Orleans Saints,@,Green Bay Packers,26,17,485,2,260,1,0,9,225,1,False,True
2017-10-22,7,Sun,1:00PM,Minnesota Vikings,,Baltimore Ravens,24,16,357,1,208,0,0,8,149,1,True,False
2017-10-22,7,Sun,4:05PM,Dallas Cowboys,@,San Francisco 49ers,40,10,501,0,290,3,0,30,211,-3,False,True
2017-10-22,7,Sun,4:25PM,Pittsburgh Steelers,,Cincinnati Bengals,29,14,420,0,179,2,0,15,241,-2,True,False
2017-10-22,7,Sun,4:25PM,Los Angeles Chargers,,Denver Broncos,21,0,242,0,251,3,0,21,-9,-3,True,False
2017-10-22,7,Sun,4:25PM,Seattle Seahawks,@,New York Giants,24,7,425,1,177,1,0,17,248,0,False,True
2017-10-22,7,Sun,1:00PM,Tennessee Titans,@,Cleveland Browns,12,9,269,1,284,3,0,3,-15,-2,False,True
2017-10-22,7,Sun,1:00PM,Chicago Bears,,Carolina Panthers,17,3,153,0,293,3,0,14,-140,-3,True,False
2017-10-23,7,Mon,8:30PM,Philadelphia Eagles,,Washington Commanders,34,24,371,1,344,1,0,10,27,0,True,False
2017-10-26,8,Thu,8:25PM,Baltimore Ravens,,Miami Dolphins,40,0,295,0,196,2,0,40,99,-2,True,False
2017-10-29,8,Sun,1:00PM,Atlanta Falcons,@,New York Jets,25,20,386,2,279,1,0,5,107,1,False,True
2017-10-29,8,Sun,1:00PM,Buffalo Bills,,Las Vegas Raiders,34,14,331,0,367,4,0,20,-36,-4,True,False
2017-10-29,8,Sun,1:00PM,Cincinnati Bengals,,Indianapolis Colts,24,23,276,2,331,1,0,1,-55,1,True,False
2017-10-29,8,Sun,1:00PM,Carolina Panthers,@,Tampa Bay Buccaneers,17,3,254,1,279,3,0,14,-25,-2,False,True
2017-10-29,8,Sun,1:00PM,New Orleans Saints,,Chicago Bears,20,12,387,2,307,1,0,8,80,1,True,False
2017-10-29,8,Sun,1:00PM,New England Patriots,,Los Angeles Chargers,21,13,414,0,349,1,0,8,65,-1,True,False
2017-10-29,8,Sun,1:00PM,Philadelphia Eagles,,San Francisco 49ers,33,10,304,1,238,2,0,23,66,-1,True,False
2017-10-29,8,Sun,4:05PM,Seattle Seahawks,,Houston Texans,41,38,479,1,509,3,0,3,-30,-2,True,False
2017-10-29,8,Sun,4:25PM,Dallas Cowboys,@,Washington Commanders,33,19,307,1,285,3,0,14,22,-2,False,True
2017-10-29,8,Sun,8:30PM,Pittsburgh Steelers,@,Detroit Lions,20,15,392,2,482,1,0,5,-90,1,False,True
2017-10-29,8,Sun,9:30AM,Minnesota Vikings,@,Cleveland Browns,33,16,375,1,276,2,0,17,99,-1,False,True
2017-10-30,8,Mon,8:30PM,Kansas City Chiefs,,Denver Broncos,29,19,276,2,364,5,0,10,-88,-3,True,False
2017-11-02,9,Thu,8:25PM,New York Jets,,Buffalo Bills,34,21,331,0,307,3,0,13,24,-3,True,False
2017-11-05,9,Sun,1:00PM,Jacksonville Jaguars,,Cincinnati Bengals,23,7,408,1,148,0,0,16,260,1,True,False
2017-11-05,9,Sun,1:00PM,Philadelphia Eagles,,Denver Broncos,51,23,419,1,226,2,0,28,193,-1,True,False
2017-11-05,9,Sun,1:00PM,New Orleans Saints,,Tampa Bay Buccaneers,30,10,407,2,200,1,0,20,207,1,True,False
2017-11-05,9,Sun,1:00PM,Los Angeles Rams,@,New York Giants,51,17,473,0,319,3,0,34,154,-3,False,True
2017-11-05,9,Sun,1:00PM,Tennessee Titans,,Baltimore Ravens,23,20,257,1,341,2,0,3,-84,-1,True,False
2017-11-05,9,Sun,1:00PM,Indianapolis Colts,@,Houston Texans,20,14,371,1,288,1,0,6,83,0,False,True
2017-11-05,9,Sun,4:05PM,Arizona Cardinals,@,San Francisco 49ers,20,10,368,2,329,2,0,10,39,0,False,True
2017-11-05,9,Sun,4:05PM,Washington Commanders,@,Seattle Seahawks,17,14,244,1,437,2,0,3,-193,-1,False,True
2017-11-05,9,Sun,4:25PM,Dallas Cowboys,,Kansas City Chiefs,28,17,375,0,323,1,0,11,52,-1,True,False
2017-11-05,9,Sun,8:30PM,Las Vegas Raiders,@,Miami Dolphins,27,24,379,2,395,1,0,3,-16,1,False,True
2017-11-05,9,Sun,1:00PM,Carolina Panthers,,Atlanta Falcons,20,17,330,2,355,1,0,3,-25,1,True,False
2017-11-06,9,Mon,8:30PM,Detroit Lions,@,Green Bay Packers,30,17,417,1,311,0,0,13,106,1,False,True
2017-11-09,10,Thu,8:25PM,Seattle Seahawks,@,Arizona Cardinals,22,16,287,0,290,1,0,6,-3,-1,False,True
2017-11-12,10,Sun,1:00PM,New Orleans Saints,@,Buffalo Bills,47,10,482,1,198,1,0,37,284,0,False,True
2017-11-12,10,Sun,1:00PM,Tennessee Titans,,Cincinnati Bengals,24,20,416,2,308,2,0,4,108,0,True,False
2017-11-12,10,Sun,1:00PM,Green Bay Packers,@,Chicago Bears,23,16,342,0,323,1,0,7,19,-1,False,True
2017-11-12,10,Sun,8:30PM,New England Patriots,@,Denver Broncos,41,16,396,0,339,2,0,25,57,-2,False,True
2017-11-12,10,Sun,4:25PM,Atlanta Falcons,,Dallas Cowboys,27,7,336,1,233,2,0,20,103,-1,True,False
2017-11-12,10,Sun,4:05PM,Los Angeles Rams,,Houston Texans,33,7,443,0,283,4,0,26,160,-4,True,False
2017-11-12,10,Sun,4:25PM,San Francisco 49ers,,New York Giants,31,21,474,2,374,1,0,10,100,1,True,False
2017-11-12,10,Sun,1:00PM,Pittsburgh Steelers,@,Indianapolis Colts,20,17,316,1,267,1,0,3,49,0,False,True
2017-11-12,10,Sun,1:00PM,Minnesota Vikings,@,Washington Commanders,38,30,406,2,394,1,0,8,12,1,False,True
2017-11-12,10,Sun,1:00PM,Jacksonville Jaguars,,Los Angeles Chargers,20,17,398,2,322,2,0,3,76,0,True,False
2017-11-12,10,Sun,1:00PM,Detroit Lions,,Cleveland Browns,38,24,345,1,413,2,0,14,-68,-1,True,False
2017-11-12,10,Sun,1:00PM,Tampa Bay Buccaneers,,New York Jets,15,10,271,1,275,2,0,5,-4,-1,True,False
2017-11-13,10,Mon,8:30PM,Carolina Panthers,,Miami Dolphins,45,21,548,0,313,1,0,24,235,-1,True,False
2017-11-16,11,Thu,8:25PM,Pittsburgh Steelers,,Tennessee Titans,40,17,349,0,316,4,0,23,33,-4,True,False
2017-11-19,11,Sun,4:05PM,Los Angeles Chargers,,Buffalo Bills,54,24,429,0,393,6,0,30,36,-6,True,False
2017-11-19,11,Sun,8:30PM,Philadelphia Eagles,@,Dallas Cowboys,37,9,383,0,225,4,0,28,158,-4,False,True
2017-11-19,11,Sun,4:25PM,New England Patriots,@,Las Vegas Raiders,33,8,421,0,344,2,0,25,77,-2,False,True
2017-11-19,11,Sun,4:25PM,Cincinnati Bengals,@,Denver Broncos,20,17,190,0,341,2,0,3,-151,-2,False,True
2017-11-19,11,Sun,1:00PM,New Orleans Saints,,Washington Commanders,34,31,535,1,456,0,0,3,79,1,True,False
2017-11-19,11,Sun,1:00PM,Jacksonville Jaguars,@,Cleveland Browns,19,7,284,1,184,5,0,12,100,-4,False,True
2017-11-19,11,Sun,1:00PM,Tampa Bay Buccaneers,@,Miami Dolphins,30,20,321,0,448,5,0,10,-127,-5,False,True
2017-11-19,11,Sun,1:00PM,New York Giants,,Kansas City Chiefs,12,9,317,1,363,3,0,3,-46,-2,True,False
2017-11-19,11,Sun,1:00PM,Baltimore Ravens,@,Green Bay Packers,23,0,219,1,265,5,0,23,-46,-4,False,True
2017-11-19,11,Sun,1:00PM,Houston Texans,,Arizona Cardinals,31,21,357,2,292,2,0,10,65,0,True,False
2017-11-19,11,Sun,1:00PM,Detroit Lions,@,Chicago Bears,27,24,352,1,398,1,0,3,-46,0,False,True
2017-11-19,11,Sun,1:00PM,Minnesota Vikings,,Los Angeles Rams,24,7,451,0,254,1,0,17,197,-1,True,False
2017-11-20,11,Mon,8:30PM,Atlanta Falcons,@,Seattle Seahawks,34,31,279,1,360,2,0,3,-81,-1,False,True
2017-11-23,12,Thu,4:30PM,Los Angeles Chargers,@,Dallas Cowboys,28,6,515,0,247,2,0,22,268,-2,False,True
2017-11-23,12,Thu,12:30PM,Minnesota Vikings,@,Detroit Lions,30,23,408,0,289,2,0,7,119,-2,False,True
2017-11-23,12,Thu,8:30PM,Washington Commanders,,New York Giants,20,10,323,1,170,1,0,10,153,0,True,False
2017-11-26,12,Sun,1:00PM,Buffalo Bills,@,Kansas City Chiefs,16,10,268,0,236,1,0,6,32,-1,False,True
2017-11-26,12,Sun,8:30PM,Pittsburgh Steelers,,Green Bay Packers,31,28,462,3,307,0,0,3,155,3,True,False
2017-11-26,12,Sun,1:00PM,Atlanta Falcons,,Tampa Bay Buccaneers,34,20,516,1,373,0,0,14,143,1,True,False
2017-11-26,12,Sun,4:25PM,Las Vegas Raiders,,Denver Broncos,21,14,348,1,216,1,0,7,132,0,True,False
2017-11-26,12,Sun,4:25PM,Arizona Cardinals,,Jacksonville Jaguars,27,24,344,2,219,3,0,3,125,-1,True,False
2017-11-26,12,Sun,4:25PM,Los Angeles Rams,,New Orleans Saints,26,20,415,1,346,0,0,6,69,1,True,False
2017-11-26,12,Sun,1:00PM,New England Patriots,,Miami Dolphins,35,17,417,2,221,3,0,18,196,-1,True,False
2017-11-26,12,Sun,1:00PM,Tennessee Titans,@,Indianapolis Colts,20,16,276,2,254,1,0,4,22,1,False,True
2017-11-26,12,Sun,1:00PM,Cincinnati Bengals,,Cleveland Browns,30,16,361,0,405,0,0,14,-44,0,True,False
2017-11-26,12,Sun,1:00PM,Philadelphia Eagles,,Chicago Bears,31,3,420,3,140,2,0,28,280,1,True,False
2017-11-26,12,Sun,1:00PM,Carolina Panthers,@,New York Jets,35,27,299,0,391,1,0,8,-92,-1,False,True
2017-11-26,12,Sun,4:05PM,Seattle Seahawks,@,San Francisco 49ers,24,13,318,1,280,1,0,11,38,0,False,True
2017-11-27,12,Mon,8:30PM,Baltimore Ravens,,Houston Texans,23,16,294,0,303,3,0,7,-9,-3,True,False
2017-11-30,13,Thu,8:25PM,Dallas Cowboys,,Washington Commanders,38,14,275,0,280,4,0,24,-5,-4,True,False
2017-12-03,13,Sun,1:00PM,New York Jets,,Kansas City Chiefs,38,31,488,0,474,0,0,7,14,0,True,False
2017-12-03,13,Sun,8:30PM,Seattle Seahawks,,Philadelphia Eagles,24,10,310,0,425,2,0,14,-115,-2,True,False
2017-12-03,13,Sun,4:25PM,Las Vegas Raiders,,New York Giants,24,17,401,1,265,2,0,7,136,-1,True,False
2017-12-03,13,Sun,4:25PM,Los Angeles Rams,@,Arizona Cardinals,32,16,303,1,305,2,0,16,-2,-1,False,True
2017-12-03,13,Sun,4:25PM,New Orleans Saints,,Carolina Panthers,31,21,400,1,279,1,0,10,121,0,True,False
2017-12-03,13,Sun,1:00PM,Tennessee Titans,,Houston Texans,24,13,344,1,384,1,0,11,-40,0,True,False
2017-12-03,13,Sun,4:05PM,Los Angeles Chargers,,Cleveland Browns,19,10,429,0,291,2,0,9,138,-2,True,False
2017-12-03,13,Sun,1:00PM,Baltimore Ravens,,Detroit Lions,44,20,370,0,372,3,0,24,-2,-3,True,False
2017-12-03,13,Sun,1:00PM,Miami Dolphins,,Denver Broncos,35,9,367,3,270,3,0,26,97,0,True,False
2017-12-03,13,Sun,1:00PM,Jacksonville Jaguars,,Indianapolis Colts,30,10,426,0,290,2,0,20,136,-2,True,False
2017-12-03,13,Sun,1:00PM,San Francisco 49ers,@,Chicago Bears,15,14,388,1,147,0,0,1,241,1,False,True
2017-12-03,13,Sun,1:00PM,New England Patriots,@,Buffalo Bills,23,3,435,1,268,1,0,20,167,0,False,True
2017-12-03,13,Sun,1:00PM,Minnesota Vikings,@,Atlanta Falcons,14,9,312,0,275,0,0,5,37,0,False,True
2017-12-03,13,Sun,1:00PM,Green Bay Packers,,Tampa Bay Buccaneers,26,20,276,1,395,1,0,6,-119,0,True,False
2017-12-04,13,Mon,8:30PM,Pittsburgh Steelers,@,Cincinnati Bengals,23,20,374,1,353,0,0,3,21,1,False,True
2017-12-07,14,Thu,8:25PM,Atlanta Falcons,,New Orleans Saints,20,17,343,3,306,1,0,3,37,2,True,False
2017-12-10,14,Sun,8:30PM,Pittsburgh Steelers,,Baltimore Ravens,39,38,545,0,413,1,0,1,132,-1,True,False
2017-12-10,14,Sun,4:25PM,Philadelphia Eagles,@,Los Angeles Rams,43,35,455,1,307,2,0,8,148,-1,False,True
2017-12-10,14,Sun,4:25PM,Jacksonville Jaguars,,Seattle Seahawks,30,24,424,1,401,3,0,6,23,-2,True,False
2017-12-10,14,Sun,4:05PM,Los Angeles Chargers,,Washington Commanders,30,13,488,1,201,1,0,17,287,0,True,False
2017-12-10,14,Sun,4:05PM,Denver Broncos,,New York Jets,23,0,273,0,100,2,0,23,173,-2,True,False
2017-12-10,14,Sun,4:05PM,Arizona Cardinals,,Tennessee Titans,12,7,261,0,204,2,0,5,57,-2,True,False
2017-12-10,14,Sun,1:00PM,Kansas City Chiefs,,Las Vegas Raiders,26,15,408,1,268,3,0,11,140,-2,True,False
2017-12-10,14,Sun,1:00PM,San Francisco 49ers,@,Houston Texans,26,16,416,1,311,1,0,10,105,0,False,True
2017-12-10,14,Sun,1:00PM,Detroit Lions,@,Tampa Bay Buccaneers,24,21,434,3,400,5,0,3,34,-2,False,True
2017-12-10,14,Sun,1:00PM,Dallas Cowboys,@,New York Giants,30,10,454,0,330,2,0,20,124,-2,False,True
2017-12-10,14,Sun,1:00PM,Green Bay Packers,@,Cleveland Browns,27,21,341,0,345,2,0,6,-4,-2,False,True
2017-12-10,14,Sun,1:00PM,Chicago Bears,@,Cincinnati Bengals,33,7,482,0,234,2,0,26,248,-2,False,True
2017-12-10,14,Sun,1:00PM,Carolina Panthers,,Minnesota Vikings,31,24,345,1,356,3,0,7,-11,-2,True,False
2017-12-10,14,Sun,1:00PM,Buffalo Bills,,Indianapolis Colts,13,7,319,2,227,0,0,6,92,2,True,False
2017-12-11,14,Mon,8:30PM,Miami Dolphins,,New England Patriots,27,20,362,0,248,2,0,7,114,-2,True,False
2017-12-14,15,Thu,8:25PM,Denver Broncos,@,Indianapolis Colts,25,13,462,1,228,0,0,12,234,1,False,True
2017-12-16,15,Sat,4:30PM,Detroit Lions,,Chicago Bears,20,10,293,1,349,3,0,10,-56,-2,True,False
2017-12-16,15,Sat,8:25PM,Kansas City Chiefs,,Los Angeles Chargers,30,13,397,0,307,4,0,17,90,-4,True,False
2017-12-17,15,Sun,8:30PM,Dallas Cowboys,@,Las Vegas Raiders,20,17,330,2,293,1,0,3,37,1,False,True
2017-12-17,15,Sun,4:25PM,San Francisco 49ers,,Tennessee Titans,25,23,414,0,328,1,0,2,86,-1,True,False
2017-12-17,15,Sun,4:25PM,New England Patriots,@,Pittsburgh Steelers,27,24,360,1,413,1,0,3,-53,0,False,True
2017-12-17,15,Sun,4:05PM,Los Angeles Rams,@,Seattle Seahawks,42,7,352,1,149,2,0,35,203,-1,False,True
2017-12-17,15,Sun,1:00PM,Philadelphia Eagles,@,New York Giants,34,29,341,0,504,1,0,5,-163,-1,False,True
2017-12-17,15,Sun,1:00PM,Baltimore Ravens,@,Cleveland Browns,27,10,376,0,266,4,0,17,110,-4,False,True
2017-12-17,15,Sun,1:00PM,Jacksonville Jaguars,,Houston Texans,45,7,464,0,186,1,0,38,278,-1,True,False
2017-12-17,15,Sun,1:00PM,Washington Commanders,,Arizona Cardinals,20,15,218,1,286,2,0,5,-68,-1,True,False
2017-12-17,15,Sun,1:00PM,New Orleans Saints,,New York Jets,31,19,412,3,294,2,0,12,118,1,True,False
2017-12-17,15,Sun,1:00PM,Minnesota Vikings,,Cincinnati Bengals,34,7,346,1,161,2,0,27,185,-1,True,False
2017-12-17,15,Sun,1:00PM,Carolina Panthers,,Green Bay Packers,31,24,387,0,384,4,0,7,3,-4,True,False
2017-12-17,15,Sun,1:00PM,Buffalo Bills,,Miami Dolphins,24,16,328,0,349,3,0,8,-21,-3,True,False
2017-12-18,15,Mon,8:30PM,Atlanta Falcons,@,Tampa Bay Buccaneers,24,21,410,0,373,1,0,3,37,-1,False,True
2017-12-23,16,Sat,8:30PM,Minnesota Vikings,@,Green Bay Packers,16,0,236,0,239,2,0,16,-3,-2,False,True
2017-12-23,16,Sat,4:30PM,Baltimore Ravens,,Indianapolis Colts,23,16,323,0,296,0,0,7,27,0,True,False
2017-12-24,16,Sun,1:00PM,New Orleans Saints,,Atlanta Falcons,23,13,315,1,331,2,0,10,-16,-1,True,False
2017-12-24,16,Sun,4:25PM,Seattle Seahawks,@,Dallas Cowboys,21,12,136,0,282,3,0,9,-146,-3,False,True
2017-12-24,16,Sun,4:05PM,San Francisco 49ers,,Jacksonville Jaguars,44,33,369,1,472,3,0,11,-103,-2,True,False
2017-12-24,16,Sun,1:00PM,Los Angeles Rams,@,Tennessee Titans,27,23,402,1,366,1,0,4,36,0,False,True
2017-12-24,16,Sun,1:00PM,Los Angeles Chargers,@,New York Jets,14,7,379,0,295,3,0,7,84,-3,False,True
2017-12-24,16,Sun,4:25PM,Arizona Cardinals,,New York Giants,23,0,289,2,293,3,0,23,-4,-1,True,False
2017-12-24,16,Sun,1:00PM,Washington Commanders,,Denver Broncos,27,11,386,2,330,3,0,16,56,-1,True,False
2017-12-24,16,Sun,1:00PM,Cincinnati Bengals,,Detroit Lions,26,17,364,1,276,1,0,9,88,0,True,False
2017-12-24,16,Sun,1:00PM,Chicago Bears,,Cleveland Browns,20,3,258,0,254,3,0,17,4,-3,True,False
2017-12-24,16,Sun,1:00PM,Carolina Panthers,,Tampa Bay Buccaneers,22,19,255,1,392,3,0,3,-137,-2,True,False
2017-12-24,16,Sun,1:00PM,New England Patriots,,Buffalo Bills,37,16,411,1,326,0,0,21,85,1,True,False
2017-12-24,16,Sun,1:00PM,Kansas City Chiefs,,Miami Dolphins,29,13,404,0,345,2,0,16,59,-2,True,False
2017-12-25,16,Mon,4:30PM,Pittsburgh Steelers,@,Houston Texans,34,6,330,0,227,2,0,28,103,-2,False,True
2017-12-25,16,Mon,8:30PM,Philadelphia Eagles,,Las Vegas Raiders,19,10,216,2,274,5,0,9,-58,-3,True,False
2017-12-31,17,Sun,4:25PM,San Francisco 49ers,@,Los Angeles Rams,34,13,461,3,251,2,0,21,210,1,False,True
2017-12-31,17,Sun,4:25PM,Los Angeles Chargers,,Las Vegas Raiders,30,10,495,0,336,2,0,20,159,-2,True,False
2017-12-31,17,Sun,4:25PM,Tampa Bay Buccaneers,,New Orleans Saints,31,24,455,3,323,1,0,7,132,2,True,False
2017-12-31,17,Sun,4:25PM,Tennessee Titans,,Jacksonville Jaguars,15,10,232,1,229,4,0,5,3,-3,True,False
2017-12-31,17,Sun,4:25PM,Kansas City Chiefs,@,Denver Broncos,27,24,379,2,336,3,0,3,43,-1,False,True
2017-12-31,17,Sun,4:25PM,Arizona Cardinals,@,Seattle Seahawks,26,24,259,1,296,0,0,2,-37,1,False,True
2017-12-31,17,Sun,4:25PM,Cincinnati Bengals,@,Baltimore Ravens,31,27,359,1,312,1,0,4,47,0,False,True
2017-12-31,17,Sun,1:00PM,New York Giants,,Washington Commanders,18,10,381,1,197,3,0,8,184,-2,True,False
2017-12-31,17,Sun,4:25PM,Atlanta Falcons,,Carolina Panthers,22,10,371,0,248,3,0,12,123,-3,True,False
2017-12-31,17,Sun,4:25PM,Buffalo Bills,@,Miami Dolphins,22,16,312,0,356,1,0,6,-44,-1,False,True
2017-12-31,17,Sun,1:00PM,Minnesota Vikings,,Chicago Bears,23,10,327,0,201,0,0,13,126,0,True,False
2017-12-31,17,Sun,1:00PM,Pittsburgh Steelers,,Cleveland Browns,28,24,348,2,374,2,0,4,-26,0,True,False
2017-12-31,17,Sun,1:00PM,Indianapolis Colts,,Houston Texans,22,13,250,0,209,1,0,9,41,-1,True,False
2017-12-31,17,Sun,1:00PM,Dallas Cowboys,@,Philadelphia Eagles,6,0,301,1,219,2,0,6,82,-1,False,True
2017-12-31,17,Sun,1:00PM,Detroit Lions,,Green Bay Packers,35,11,356,0,256,4,0,24,100,-4,True,False
2017-12-31,17,Sun,1:00PM,New England Patriots,,New York Jets,26,6,330,0,247,0,0,20,83,0,True,False
2018-01-06,WildCard,Sat,4:35PM,Tennessee Titans,@,Kansas City Chiefs,22,21,397,2,325,0,0,1,72,2,False,True
2018-01-06,WildCard,Sat,8:15PM,Atlanta Falcons,@,Los Angeles Rams,26,13,322,0,361,2,0,13,-39,-2,False,True
2018-01-07,WildCard,Sun,1:05PM,Jacksonville Jaguars,,Buffalo Bills,10,3,230,0,263,2,0,7,-33,-2,True,False
2018-01-07,WildCard,Sun,4:40PM,New Orleans Saints,,Carolina Panthers,31,26,410,1,413,0,0,5,-3,1,True,False
2018-01-13,Division,Sat,4:35PM,Philadelphia Eagles,,Atlanta Falcons,15,10,334,2,281,0,0,5,53,2,True,False
2018-01-13,Division,Sat,8:15PM,New England Patriots,,Tennessee Titans,35,14,438,0,267,0,0,21,171,0,True,False
2018-01-14,Division,Sun,1:05PM,Jacksonville Jaguars,@,Pittsburgh Steelers,45,42,378,0,545,2,0,3,-167,-2,False,True
2018-01-14,Division,Sun,4:40PM,Minnesota Vikings,,New Orleans Saints,29,24,403,1,358,2,0,5,45,-1,True,False
2018-01-21,ConfChamp,Sun,3:05PM,New England Patriots,,Jacksonville Jaguars,24,20,344,1,374,0,0,4,-30,1,True,False
2018-01-21,ConfChamp,Sun,6:40PM,Philadelphia Eagles,,Minnesota Vikings,38,7,456,0,333,3,0,31,123,-3,True,False
2018-02-04,SuperBowl,Sun,6:30PM,Philadelphia Eagles,N,New England Patriots,41,33,538,1,613,1,0,8,-75,0,False,False
2018-09-06,1,Thu,8:20PM,Philadelphia Eagles,,Atlanta Falcons,18,12,232,2,299,1,0,6,-67,1,True,False
2018-09-09,1,Sun,8:20PM,Green Bay Packers,,Chicago Bears,24,23,370,2,294,1,0,1,76,1,True,False
2018-09-09,1,Sun,4:25PM,Denver Broncos,,Seattle Seahawks,27,24,470,3,306,3,0,3,164,0,True,False
2018-09-09,1,Sun,4:25PM,Carolina Panthers,,Dallas Cowboys,16,8,293,1,232,1,0,8,61,0,True,False
2018-09-09,1,Sun,4:05PM,Kansas City Chiefs,@,Los Angeles Chargers,38,28,362,0,541,2,0,10,-179,-2,False,True
2018-09-09,1,Sun,1:00PM,Tampa Bay Buccaneers,@,New Orleans Saints,48,40,529,0,475,2,0,8,54,-2,False,True
2018-09-09,1,Sun,1:00PM,Minnesota Vikings,,San Francisco 49ers,24,16,343,1,327,4,0,8,16,-3,True,False
2018-09-09,1,Sun,4:25PM,Washington Commanders,@,Arizona Cardinals,24,6,429,1,213,2,0,18,216,-1,False,True
2018-09-09,1,Sun,1:00PM,Jacksonville Jaguars,@,New York Giants,20,15,305,1,324,2,0,5,-19,-1,False,True
2018-09-09,1,Sun,1:00PM,New England Patriots,,Houston Texans,27,20,389,3,325,2,0,7,64,1,True,False
2018-09-09,1,Sun,1:00PM,Pittsburgh Steelers,@,Cleveland Browns,21,21,472,6,327,1,1,0,145,5,False,True
2018-09-09,1,Sun,1:00PM,Cincinnati Bengals,@,Indianapolis Colts,34,23,330,2,380,2,0,11,-50,0,False,True
2018-09-09,1,Sun,1:00PM,Baltimore Ravens,,Buffalo Bills,47,3,369,1,153,2,0,44,216,-1,True,False
2018-09-09,1,Sun,1:00PM,Miami Dolphins,,Tennessee Titans,27,20,342,2,336,3,0,7,6,-1,True,False
2018-09-10,1,Mon,7:10PM,New York Jets,@,Detroit Lions,48,17,349,2,339,5,0,31,10,-3,False,True
2018-09-10,1,Mon,10:20PM,Los Angeles Rams,@,Las Vegas Raiders,33,13,365,0,395,3,0,20,-30,-3,False,True
2018-09-13,2,Thu,8:20PM,Cincinnati Bengals,,Baltimore Ravens,34,23,373,0,425,3,0,11,-52,-3,True,False
2018-09-16,2,Sun,1:00PM,Tampa Bay Buccaneers,,Philadelphia Eagles,27,21,436,2,412,2,0,6,24,0,True,False
2018-09-16,2,Sun,8:20PM,Dallas Cowboys,,New York Giants,20,13,298,0,255,1,0,7,43,-1,True,False
2018-09-16,2,Sun,4:25PM,Jacksonville Jaguars,,New England Patriots,31,20,480,2,302,1,0,11,178,1,True,False
2018-09-16,2,Sun,4:25PM,Denver Broncos,,Las Vegas Raiders,20,19,385,1,373,0,0,1,12,1,True,False
2018-09-16,2,Sun,4:05PM,San Francisco 49ers,,Detroit Lions,30,27,346,0,427,1,0,3,-81,-1,True,False
2018-09-16,2,Sun,4:05PM,Los Angeles Rams,,Arizona Cardinals,34,0,432,1,137,1,0,34,295,0,True,False
2018-09-16,2,Sun,1:00PM,Miami Dolphins,@,New York Jets,20,12,257,2,362,3,0,8,-105,-1,False,True
2018-09-16,2,Sun,1:00PM,New Orleans Saints,,Cleveland Browns,21,18,275,2,327,1,0,3,-52,1,True,False
2018-09-16,2,Sun,1:00PM,Tennessee Titans,,Houston Texans,20,17,283,0,437,1,0,3,-154,-1,True,False
2018-09-16,2,Sun,1:00PM,Minnesota Vikings,@,Green Bay Packers,29,29,480,1,351,0,1,0,129,1,False,True
2018-09-16,2,Sun,1:00PM,Indianapolis Colts,@,Washington Commanders,21,9,281,2,334,1,0,12,-53,1,False,True
2018-09-16,2,Sun,1:00PM,Los Angeles Chargers,@,Buffalo Bills,31,20,349,0,293,2,0,11,56,-2,False,True
2018-09-16,2,Sun,1:00PM,Atlanta Falcons,,Carolina Panthers,31,24,442,1,439,1,0,7,3,0,True,False
2018-09-16,2,Sun,1:00PM,Kansas City Chiefs,@,Pittsburgh Steelers,42,37,449,1,475,0,0,5,-26,1,False,True
2018-09-17,2,Mon,8:15PM,Chicago Bears,,Seattle Seahawks,24,17,271,2,276,2,0,7,-5,0,True,False
2018-09-20,3,Thu,8:20PM,Cleveland Browns,,New York Jets,21,17,323,0,268,3,0,4,55,-3,True,False
2018-09-23,3,Sun,1:00PM,Kansas City Chiefs,,San Francisco 49ers,38,27,384,0,406,0,0,11,-22,0,True,False
2018-09-23,3,Sun,8:20PM,Detroit Lions,,New England Patriots,26,10,414,1,209,1,0,16,205,0,True,False
2018-09-23,3,Sun,4:25PM,Seattle Seahawks,,Dallas Cowboys,24,13,295,0,303,3,0,11,-8,-3,True,False
2018-09-23,3,Sun,4:25PM,Chicago Bears,@,Arizona Cardinals,16,14,316,2,221,4,0,2,95,-2,False,True
2018-09-23,3,Sun,4:05PM,Los Angeles Rams,,Los Angeles Chargers,35,23,521,2,356,2,0,12,165,0,True,False
2018-09-23,3,Sun,1:00PM,Miami Dolphins,,Las Vegas Raiders,28,20,373,0,434,2,0,8,-61,-2,True,False
2018-09-23,3,Sun,1:00PM,Tennessee Titans,@,Jacksonville Jaguars,9,6,233,0,232,1,0,3,1,-1,False,True
2018-09-23,3,Sun,1:00PM,Baltimore Ravens,,Denver Broncos,27,14,342,0,293,1,0,13,49,-1,True,False
2018-09-23,3,Sun,1:00PM,Washington Commanders,,Green Bay Packers,31,17,386,1,340,1,0,14,46,0,True,False
2018-09-23,3,Sun,1:00PM,Philadelphia Eagles,,Indianapolis Colts,20,16,379,2,209,0,0,4,170,2,True,False
2018-09-23,3,Sun,1:00PM,Carolina Panthers,,Cincinnati Bengals,31,21,377,0,396,4,0,10,-19,-4,True,False
2018-09-23,3,Sun,1:00PM,Buffalo Bills,@,Minnesota Vikings,27,6,292,0,292,3,0,21,0,-3,False,True
2018-09-23,3,Sun,1:00PM,New Orleans Saints,@,Atlanta Falcons,43,37,534,0,407,0,0,6,127,0,False,True
2018-09-23,3,Sun,1:00PM,New York Giants,@,Houston Texans,27,22,379,0,427,2,0,5,-48,-2,False,True
2018-09-24,3,Mon,8:15PM,Pittsburgh Steelers,@,Tampa Bay Buccaneers,30,27,413,1,455,4,0,3,-42,-3,False,True
2018-09-27,4,Thu,8:20PM,Los Angeles Rams,,Minnesota Vikings,38,31,556,0,446,1,0,7,110,-1,True,False
2018-09-30,4,Sun,8:20PM,Baltimore Ravens,@,Pittsburgh Steelers,26,14,451,1,284,2,0,12,167,-1,False,True
2018-09-30,4,Sun,4:25PM,Los Angeles Chargers,,San Francisco 49ers,29,27,368,1,364,2,0,2,4,-1,True,False
2018-09-30,4,Sun,4:25PM,New Orleans Saints,@,New York Giants,33,18,389,0,299,2,0,15,90,-2,False,True
2018-09-30,4,Sun,4:05PM,Las Vegas Raiders,,Cleveland Browns,45,42,565,2,487,4,0,3,78,-2,True,False
2018-09-30,4,Sun,1:00PM,Tennessee Titans,,Philadelphia Eagles,26,23,397,1,432,1,0,3,-35,0,True,False
2018-09-30,4,Sun,1:00PM,New England Patriots,,Miami Dolphins,38,7,449,2,172,2,0,31,277,0,True,False
2018-09-30,4,Sun,4:05PM,Seattle Seahawks,@,Arizona Cardinals,20,17,331,0,263,1,0,3,68,-1,False,True
2018-09-30,4,Sun,1:00PM,Dallas Cowboys,,Detroit Lions,26,24,414,0,382,0,0,2,32,0,True,False
2018-09-30,4,Sun,1:00PM,Houston Texans,@,Indianapolis Colts,37,34,466,1,478,2,0,3,-12,-1,False,True
2018-09-30,4,Sun,1:00PM,Chicago Bears,,Tampa Bay Buccaneers,48,10,483,0,311,3,0,38,172,-3,True,False
2018-09-30,4,Sun,1:00PM,Green Bay Packers,,Buffalo Bills,22,0,423,2,145,3,0,22,278,-1,True,False
2018-09-30,4,Sun,1:00PM,Cincinnati Bengals,@,Atlanta Falcons,37,36,407,1,495,0,0,1,-88,1,False,True
2018-09-30,4,Sun,1:00PM,Jacksonville Jaguars,,New York Jets,31,12,503,3,178,0,0,19,325,3,True,False
2018-10-01,4,Mon,8:15PM,Kansas City Chiefs,@,Denver Broncos,27,23,446,0,385,1,0,4,61,-1,False,True
2018-10-04,5,Thu,8:20PM,New England Patriots,,Indianapolis Colts,38,24,438,2,439,3,0,14,-1,-1,True,False
2018-10-07,5,Sun,4:25PM,Arizona Cardinals,@,San Francisco 49ers,28,18,220,0,447,5,0,10,-227,-5,False,True
2018-10-07,5,Sun,4:05PM,Los Angeles Chargers,,Las Vegas Raiders,26,10,412,0,289,2,0,16,123,-2,True,False
2018-10-07,5,Sun,1:00PM,Kansas City Chiefs,,Jacksonville Jaguars,30,14,424,2,502,5,0,16,-78,-3,True,False
2018-10-07,5,Sun,1:00PM,Detroit Lions,,Green Bay Packers,31,23,264,0,521,3,0,8,-257,-3,True,False
2018-10-07,5,Sun,1:00PM,New York Jets,,Denver Broncos,34,16,512,2,436,1,0,18,76,1,True,False
2018-10-07,5,Sun,1:00PM,Pittsburgh Steelers,,Atlanta Falcons,41,17,381,1,324,1,0,24,57,0,True,False
2018-10-07,5,Sun,1:00PM,Cincinnati Bengals,,Miami Dolphins,27,17,332,1,297,3,0,10,35,-2,True,False
2018-10-07,5,Sun,1:00PM,Buffalo Bills,,Tennessee Titans,13,12,223,1,221,3,0,1,2,-2,True,False
2018-10-07,5,Sun,1:00PM,Carolina Panthers,,New York Giants,33,31,350,2,432,3,0,2,-82,-1,True,False
2018-10-07,5,Sun,4:25PM,Los Angeles Rams,@,Seattle Seahawks,33,31,468,2,373,0,0,2,95,2,False,True
2018-10-07,5,Sun,1:00PM,Cleveland Browns,,Baltimore Ravens,12,9,416,1,410,2,0,3,6,-1,True,False
2018-10-07,5,Sun,8:20PM,Houston Texans,,Dallas Cowboys,19,16,462,2,292,2,0,3,170,0,True,False
2018-10-07,5,Sun,4:25PM,Minnesota Vikings,@,Philadelphia Eagles,23,21,375,1,364,2,0,2,11,-1,False,True
2018-10-08,5,Mon,8:15PM,New Orleans Saints,,Washington Commanders,43,19,447,1,283,2,0,24,164,-1,True,False
2018-10-11,6,Thu,8:20PM,Philadelphia Eagles,@,New York Giants,34,13,379,0,401,1,0,21,-22,-1,False,True
2018-10-14,6,Sun,1:00PM,Seattle Seahawks,@,Las Vegas Raiders,27,3,369,1,185,2,0,24,184,-1,False,True
2018-10-14,6,Sun,1:00PM,Minnesota Vikings,,Arizona Cardinals,27,17,411,2,268,2,0,10,143,0,True,False
2018-10-14,6,Sun,8:20PM,New England Patriots,,Kansas City Chiefs,43,40,500,1,446,2,0,3,54,-1,True,False
2018-10-14,6,Sun,1:00PM,New York Jets,,Indianapolis Colts,42,34,374,2,428,4,0,8,-54,-2,True,False
2018-10-14,6,Sun,1:00PM,Los Angeles Chargers,@,Cleveland Browns,38,14,449,1,317,2,0,24,132,-1,False,True
2018-10-14,6,Sun,1:00PM,Pittsburgh Steelers,@,Cincinnati Bengals,28,21,481,0,275,0,0,7,206,0,False,True
2018-10-14,6,Sun,4:05PM,Los Angeles Rams,@,Denver Broncos,23,20,444,1,357,1,0,3,87,0,False,True
2018-10-14,6,Sun,1:00PM,Atlanta Falcons,,Tampa Bay Buccaneers,34,29,417,0,510,2,0,5,-93,-2,True,False
2018-10-14,6,Sun,1:00PM,Miami Dolphins,,Chicago Bears,31,28,541,3,467,3,0,3,74,0,True,False
2018-10-14,6,Sun,1:00PM,Washington Commanders,,Carolina Panthers,23,17,288,0,350,3,0,6,-62,-3,True,False
2018-10-14,6,Sun,4:25PM,Baltimore Ravens,@,Tennessee Titans,21,0,361,1,106,0,0,21,255,1,False,True
2018-10-14,6,Sun,4:25PM,Dallas Cowboys,,Jacksonville Jaguars,40,7,378,0,204,2,0,33,174,-2,True,False
2018-10-14,6,Sun,1:00PM,Houston Texans,,Buffalo Bills,20,13,216,3,229,3,0,7,-13,0,True,False
2018-10-15,6,Mon,8:15PM,Green Bay Packers,,San Francisco 49ers,33,30,521,0,401,3,0,3,120,-3,True,False
2018-10-18,7,Thu,8:20PM,Denver Broncos,@,Arizona Cardinals,45,10,309,1,223,5,0,35,86,-4,False,True
2018-10-21,7,Sun,1:00PM,Carolina Panthers,@,Philadelphia Eagles,21,17,371,0,342,1,0,4,29,-1,False,True
2018-10-21,7,Sun,1:00PM,New England Patriots,@,Chicago Bears,38,31,381,3,453,2,0,7,-72,1,False,True
2018-10-21,7,Sun,1:00PM,Indianapolis Colts,,Buffalo Bills,37,5,376,0,303,5,0,32,73,-5,True,False
2018-10-21,7,Sun,1:00PM,Tampa Bay Buccaneers,,Cleveland Browns,26,23,456,4,305,1,0,3,151,3,True,False
2018-10-21,7,Sun,1:00PM,Houston Texans,@,Jacksonville Jaguars,20,7,272,0,259,3,0,13,13,-3,False,True
2018-10-21,7,Sun,1:00PM,Minnesota Vikings,@,New York Jets,37,17,316,0,263,4,0,20,53,-4,False,True
2018-10-21,7,Sun,4:05PM,New Orleans Saints,@,Baltimore Ravens,24,23,339,1,351,0,0,1,-12,1,False,True
2018-10-21,7,Sun,4:25PM,Washington Commanders,,Dallas Cowboys,20,17,305,0,323,2,0,3,-18,-2,True,False
2018-10-21,7,Sun,8:20PM,Kansas City Chiefs,,Cincinnati Bengals,45,10,551,1,239,1,0,35,312,0,True,False
2018-10-21,7,Sun,9:30AM,Los Angeles Chargers,,Tennessee Titans,20,19,344,0,390,1,0,1,-46,-1,True,False
2018-10-21,7,Sun,1:00PM,Detroit Lions,@,Miami Dolphins,32,21,457,0,322,0,0,11,135,0,False,True
2018-10-21,7,Sun,4:25PM,Los Angeles Rams,@,San Francisco 49ers,39,10,339,0,228,4,0,29,111,-4,False,True
2018-10-22,7,Mon,8:15PM,Atlanta Falcons,,New York Giants,23,20,423,1,433,0,0,3,-10,1,True,False
2018-10-25,8,Thu,8:20PM,Houston Texans,,Miami Dolphins,42,23,427,0,370,1,0,19,57,-1,True,False
2018-10-28,8,Sun,8:20PM,New Orleans Saints,@,Minnesota Vikings,30,20,270,1,423,2,0,10,-153,-1,False,True
2018-10-28,8,Sun,4:25PM,Arizona Cardinals,,San Francisco 49ers,18,15,321,2,267,0,0,3,54,2,True,False
2018-10-28,8,Sun,4:25PM,Los Angeles Rams,,Green Bay Packers,29,27,416,0,359,1,0,2,57,-1,True,False
2018-10-28,8,Sun,4:05PM,Indianapolis Colts,@,Las Vegas Raiders,42,28,461,0,347,1,0,14,114,-1,False,True
2018-10-28,8,Sun,1:00PM,Washington Commanders,@,New York Giants,20,13,360,1,303,2,0,7,57,-1,False,True
2018-10-28,8,Sun,1:00PM,Pittsburgh Steelers,,Cleveland Browns,33,18,421,2,237,1,0,15,184,1,True,False
2018-10-28,8,Sun,1:00PM,Kansas City Chiefs,,Denver Broncos,30,23,340,1,411,2,0,7,-71,-1,True,False
2018-10-28,8,Sun,1:00PM,Seattle Seahawks,@,Detroit Lions,28,14,413,0,331,3,0,14,82,-3,False,True
2018-10-28,8,Sun,1:00PM,Chicago Bears,,New York Jets,24,10,395,0,207,0,0,14,188,0,True,False
2018-10-28,8,Sun,1:00PM,Carolina Panthers,,Baltimore Ravens,36,21,386,0,325,3,0,15,61,-3,True,False
2018-10-28,8,Sun,9:30AM,Philadelphia Eagles,@,Jacksonville Jaguars,24,18,395,2,335,1,0,6,60,1,False,True
2018-10-28,8,Sun,1:00PM,Cincinnati Bengals,,Tampa Bay Buccaneers,37,34,402,0,576,4,0,3,-174,-4,True,False
2018-10-29,8,Mon,8:15PM,New England Patriots,@,Buffalo Bills,25,6,387,0,333,2,0,19,54,-2,False,True
2018-11-01,9,Thu,8:20PM,San Francisco 49ers,,Las Vegas Raiders,34,3,405,0,242,0,0,31,163,0,True,False
2018-11-04,9,Sun,1:00PM,Miami Dolphins,,New York Jets,13,6,168,0,282,4,0,7,-114,-4,True,False
2018-11-04,9,Sun,4:05PM,Houston Texans,@,Denver Broncos,19,17,290,0,348,1,0,2,-58,-1,False,True
2018-11-04,9,Sun,4:05PM,Los Angeles Chargers,@,Seattle Seahawks,25,17,375,0,356,1,0,8,19,-1,False,True
2018-11-04,9,Sun,1:00PM,Kansas City Chiefs,@,Cleveland Browns,37,21,499,1,388,1,0,16,111,0,False,True
2018-11-04,9,Sun,1:00PM,Carolina Panthers,,Tampa Bay Buccaneers,42,28,407,0,301,2,0,14,106,-2,True,False
2018-11-04,9,Sun,1:00PM,Pittsburgh Steelers,@,Baltimore Ravens,23,16,395,0,265,0,0,7,130,0,False,True
2018-11-04,9,Sun,1:00PM,Minnesota Vikings,,Detroit Lions,24,9,283,2,209,1,0,15,74,1,True,False
2018-11-04,9,Sun,1:00PM,Atlanta Falcons,@,Washington Commanders,38,14,491,1,366,1,0,24,125,0,False,True
2018-11-04,9,Sun,8:20PM,New England Patriots,,Green Bay Packers,31,17,433,0,367,1,0,14,66,-1,True,False
2018-11-04,9,Sun,1:00PM,Chicago Bears,@,Buffalo Bills,41,9,190,1,264,4,0,32,-74,-3,False,True
2018-11-04,9,Sun,4:25PM,New Orleans Saints,,Los Angeles Rams,45,35,487,1,483,1,0,10,4,0,True,False
2018-11-05,9,Mon,8:15PM,Tennessee Titans,@,Dallas Cowboys,28,14,340,2,297,2,0,14,43,0,False,True
2018-11-08,10,Thu,8:20PM,Pittsburgh Steelers,,Carolina Panthers,52,21,457,0,242,2,0,31,215,-2,True,False
2018-11-11,10,Sun,1:00PM,Indianapolis Colts,,Jacksonville Jaguars,29,26,366,1,415,1,0,3,-49,0,True,False
2018-11-11,10,Sun,1:00PM,Chicago Bears,,Detroit Lions,34,22,402,0,305,3,0,12,97,-3,True,False
2018-11-11,10,Sun,1:00PM,Cleveland Browns,,Atlanta Falcons,28,16,427,1,382,2,0,12,45,-1,True,False
2018-11-11,10,Sun,8:20PM,Dallas Cowboys,@,Philadelphia Eagles,27,20,410,0,421,1,0,7,-11,-1,False,True
2018-11-11,10,Sun,4:25PM,Los Angeles Rams,,Seattle Seahawks,36,31,456,0,414,1,0,5,42,-1,True,False
2018-11-11,10,Sun,4:25PM,Green Bay Packers,,Miami Dolphins,31,12,377,1,294,2,0,19,83,-1,True,False
2018-11-11,10,Sun,1:00PM,Tennessee Titans,,New England Patriots,34,10,385,0,284,0,0,24,101,0,True,False
2018-11-11,10,Sun,4:05PM,Los Angeles Chargers,@,Las Vegas Raiders,20,6,335,1,317,1,0,14,18,0,False,True
2018-11-11,10,Sun,1:00PM,Buffalo Bills,@,New York Jets,41,10,451,0,199,2,0,31,252,-2,False,True
2018-11-11,10,Sun,1:00PM,Washington Commanders,@,Tampa Bay Buccaneers,16,3,286,0,501,4,0,13,-215,-4,False,True
2018-11-11,10,Sun,1:00PM,Kansas City Chiefs,,Arizona Cardinals,26,14,330,0,260,2,0,12,70,-2,True,False
2018-11-11,10,Sun,1:00PM,New Orleans Saints,@,Cincinnati Bengals,51,14,509,0,284,2,0,37,225,-2,False,True
2018-11-12,10,Mon,8:15PM,New York Giants,@,San Francisco 49ers,27,23,277,0,374,2,0,4,-97,-2,False,True
2018-11-15,11,Thu,8:20PM,Seattle Seahawks,,Green Bay Packers,27,24,378,1,359,0,0,3,19,1,True,False
2018-11-18,11,Sun,1:00PM,Pittsburgh Steelers,@,Jacksonville Jaguars,20,16,323,3,243,1,0,4,80,2,False,True
2018-11-18,11,Sun,4:25PM,New Orleans Saints,,Philadelphia Eagles,48,7,546,0,196,3,0,41,350,-3,True,False
2018-11-18,11,Sun,1:00PM,New York Giants,,Tampa Bay Buccaneers,38,35,359,0,510,4,0,3,-151,-4,True,False
2018-11-18,11,Sun,4:05PM,Denver Broncos,@,Los Angeles Chargers,23,22,325,0,479,2,0,1,-154,-2,False,True
2018-11-18,11,Sun,1:00PM,Houston Texans,@,Washington Commanders,23,21,320,3,278,2,0,2,42,1,False,True
2018-11-18,11,Sun,4:05PM,Las Vegas Raiders,@,Arizona Cardinals,23,21,325,0,282,2,0,2,43,-2,False,True
2018-11-18,11,Sun,1:00PM,Baltimore Ravens,,Cincinnati Bengals,24,21,403,1,255,0,0,3,148,1,True,False
2018-11-18,11,Sun,1:00PM,Indianapolis Colts,,Tennessee Titans,38,10,397,0,267,2,0,28,130,-2,True,False
2018-11-18,11,Sun,8:20PM,Chicago Bears,,Minnesota Vikings,25,20,308,3,268,3,0,5,40,0,True,False
2018-11-18,11,Sun,1:00PM,Detroit Lions,,Carolina Panthers,20,19,309,0,387,1,0,1,-78,-1,True,False
2018-11-18,11,Sun,1:00PM,Dallas Cowboys,@,Atlanta Falcons,22,19,323,0,354,1,0,3,-31,-1,False,True
2018-11-19,11,Mon,8:15PM,Los Angeles Rams,,Kansas City Chiefs,54,51,455,2,546,5,0,3,-91,-3,True,False
2018-11-22,12,Thu,12:30PM,Chicago Bears,@,Detroit Lions,23,16,264,1,333,2,0,7,-69,-1,False,True
2018-11-22,12,Thu,4:30PM,Dallas Cowboys,,Washington Commanders,31,23,404,0,331,3,0,8,73,-3,True,False
2018-11-22,12,Thu,8:20PM,New Orleans Saints,,Atlanta Falcons,31,17,312,1,366,4,0,14,-54,-3,True,False
2018-11-25,12,Sun,8:20PM,Minnesota Vikings,,Green Bay Packers,24,17,416,0,254,1,0,7,162,-1,True,False
2018-11-25,12,Sun,4:25PM,Denver Broncos,,Pittsburgh Steelers,24,17,308,0,527,4,0,7,-219,-4,True,False
2018-11-25,12,Sun,4:25PM,Indianapolis Colts,,Miami Dolphins,27,24,455,3,314,1,0,3,141,2,True,False
2018-11-25,12,Sun,4:05PM,Los Angeles Chargers,,Arizona Cardinals,45,10,414,1,149,1,0,35,265,0,True,False
2018-11-25,12,Sun,1:00PM,Tampa Bay Buccaneers,,San Francisco 49ers,27,9,412,0,342,2,0,18,70,-2,True,False
2018-11-25,12,Sun,1:00PM,New England Patriots,@,New York Jets,27,13,498,0,338,1,0,14,160,-1,False,True
2018-11-25,12,Sun,1:00PM,Cleveland Browns,@,Cincinnati Bengals,35,20,342,0,372,2,0,15,-30,-2,False,True
2018-11-25,12,Sun,1:00PM,Seattle Seahawks,@,Carolina Panthers,30,27,397,0,476,1,0,3,-79,-1,False,True
2018-11-25,12,Sun,1:00PM,Buffalo Bills,,Jacksonville Jaguars,24,21,327,0,333,2,0,3,-6,-2,True,False
2018-11-25,12,Sun,1:00PM,Baltimore Ravens,,Las Vegas Raiders,34,17,416,2,249,1,0,17,167,1,True,False
2018-11-25,12,Sun,1:00PM,Philadelphia Eagles,,New York Giants,25,22,341,0,402,1,0,3,-61,-1,True,False
2018-11-26,12,Mon,8:15PM,Houston Texans,,Tennessee Titans,34,17,462,0,365,1,0,17,97,-1,True,False
2018-11-29,13,Thu,8:20PM,Dallas Cowboys,,New Orleans Saints,13,10,308,2,176,1,0,3,132,1,True,False
2018-12-02,13,Sun,8:20PM,Los Angeles Chargers,@,Pittsburgh Steelers,33,30,371,0,336,1,0,3,35,-1,False,True
2018-12-02,13,Sun,4:25PM,Seattle Seahawks,,San Francisco 49ers,43,16,331,0,452,3,0,27,-121,-3,True,False
2018-12-02,13,Sun,4:25PM,New England Patriots,,Minnesota Vikings,24,10,471,1,278,2,0,14,193,-1,True,False
2018-12-02,13,Sun,1:00PM,Baltimore Ravens,@,Atlanta Falcons,26,16,366,1,131,1,0,10,235,0,False,True
2018-12-02,13,Sun,4:05PM,Tennessee Titans,,New York Jets,26,22,403,1,280,1,0,4,123,0,True,False
2018-12-02,13,Sun,1:00PM,Los Angeles Rams,@,Detroit Lions,30,16,344,2,310,2,0,14,34,0,False,True
2018-12-02,13,Sun,1:00PM,Arizona Cardinals,@,Green Bay Packers,20,17,315,0,325,0,0,3,-10,0,False,True
2018-12-02,13,Sun,1:00PM,Jacksonville Jaguars,,Indianapolis Colts,6,0,211,1,265,2,0,6,-54,-1,True,False
2018-12-02,13,Sun,4:05PM,Kansas City Chiefs,@,Las Vegas Raiders,40,33,469,1,442,3,0,7,27,-2,False,True
2018-12-02,13,Sun,1:00PM,Denver Broncos,@,Cincinnati Bengals,24,10,361,1,313,3,0,14,48,-2,False,True
2018-12-02,13,Sun,1:00PM,New York Giants,,Chicago Bears,30,27,338,1,376,3,0,3,-38,-2,True,False
2018-12-02,13,Sun,1:00PM,Tampa Bay Buccaneers,,Carolina Panthers,24,17,315,1,444,4,0,7,-129,-3,True,False
2018-12-02,13,Sun,1:00PM,Miami Dolphins,,Buffalo Bills,21,17,175,1,415,3,0,4,-240,-2,True,False
2018-12-02,13,Sun,1:00PM,Houston Texans,,Cleveland Browns,29,13,384,0,428,4,0,16,-44,-4,True,False
2018-12-03,13,Mon,8:15PM,Philadelphia Eagles,,Washington Commanders,28,13,436,1,235,1,0,15,201,0,True,False
2018-12-06,14,Thu,8:20PM,Tennessee Titans,,Jacksonville Jaguars,30,9,426,1,255,1,0,21,171,0,True,False
2018-12-09,14,Sun,4:05PM,Los Angeles Chargers,,Cincinnati Bengals,26,21,288,0,295,0,0,5,-7,0,True,False
2018-12-09,14,Sun,8:20PM,Chicago Bears,,Los Angeles Rams,15,6,294,3,214,4,0,9,80,-1,True,False
2018-12-09,14,Sun,4:25PM,Las Vegas Raiders,,Pittsburgh Steelers,24,21,354,1,340,1,0,3,14,0,True,False
2018-12-09,14,Sun,4:25PM,Dallas Cowboys,,Philadelphia Eagles,29,23,576,3,256,1,0,6,320,2,True,False
2018-12-09,14,Sun,4:25PM,Detroit Lions,@,Arizona Cardinals,17,3,218,1,279,1,0,14,-61,0,False,True
2018-12-09,14,Sun,4:05PM,San Francisco 49ers,,Denver Broncos,20,14,389,1,274,0,0,6,115,1,True,False
2018-12-09,14,Sun,1:00PM,New York Giants,@,Washington Commanders,40,16,402,1,288,3,0,24,114,-2,False,True
2018-12-09,14,Sun,1:00PM,Miami Dolphins,,New England Patriots,34,33,412,0,421,0,0,1,-9,0,True,False
2018-12-09,14,Sun,1:00PM,Kansas City Chiefs,,Baltimore Ravens,27,24,442,1,321,1,0,3,121,0,True,False
2018-12-09,14,Sun,1:00PM,Indianapolis Colts,@,Houston Texans,24,21,436,1,315,0,0,3,121,1,False,True
2018-12-09,14,Sun,1:00PM,Cleveland Browns,,Carolina Panthers,26,20,348,2,393,1,0,6,-45,1,True,False
2018-12-09,14,Sun,1:00PM,New York Jets,@,Buffalo Bills,27,23,248,2,368,3,0,4,-120,-1,False,True
2018-12-09,14,Sun,1:00PM,Green Bay Packers,,Atlanta Falcons,34,20,300,0,344,2,0,14,-44,-2,True,False
2018-12-09,14,Sun,1:00PM,New Orleans Saints,@,Tampa Bay Buccaneers,28,14,298,2,279,1,0,14,19,1,False,True
2018-12-10,14,Mon,8:15PM,Seattle Seahawks,,Minnesota Vikings,21,7,274,1,276,1,0,14,-2,0,True,False
2018-12-13,15,Thu,8:20PM,Los Angeles Chargers,@,Kansas City Chiefs,29,28,407,2,294,0,0,1,113,2,False,True
2018-12-15,15,Sat,4:30PM,Houston Texans,@,New York Jets,29,22,286,0,318,1,0,7,-32,-1,False,True
2018-12-15,15,Sat,8:20PM,Cleveland Browns,@,Denver Broncos,17,16,309,2,270,2,0,1,39,0,False,True
2018-12-16,15,Sun,1:00PM,Tennessee Titans,@,New York Giants,17,0,301,0,260,2,0,17,41,-2,False,True
2018-12-16,15,Sun,8:20PM,Philadelphia Eagles,@,Los Angeles Rams,30,23,381,1,407,3,0,7,-26,-2,False,True
2018-12-16,15,Sun,4:25PM,Pittsburgh Steelers,,New England Patriots,17,10,376,2,368,1,0,7,8,1,True,False
2018-12-16,15,Sun,4:05PM,San Francisco 49ers,,Seattle Seahawks,26,23,351,1,385,0,0,3,-34,1,True,False
2018-12-16,15,Sun,1:00PM,Baltimore Ravens,,Tampa Bay Buccaneers,20,12,370,2,241,1,0,8,129,1,True,False
2018-12-16,15,Sun,1:00PM,Minnesota Vikings,,Miami Dolphins,41,17,418,1,193,0,0,24,225,1,True,False
2018-12-16,15,Sun,1:00PM,Chicago Bears,,Green Bay Packers,24,17,332,1,323,1,0,7,9,0,True,False
2018-12-16,15,Sun,1:00PM,Indianapolis Colts,,Dallas Cowboys,23,0,370,1,292,1,0,23,78,0,True,False
2018-12-16,15,Sun,1:00PM,Cincinnati Bengals,,Las Vegas Raiders,30,16,294,1,297,2,0,14,-3,-1,True,False
2018-12-16,15,Sun,1:00PM,Buffalo Bills,,Detroit Lions,14,13,312,0,313,0,0,1,-1,0,True,False
2018-12-16,15,Sun,1:00PM,Atlanta Falcons,,Arizona Cardinals,40,14,435,0,253,3,0,26,182,-3,True,False
2018-12-16,15,Sun,1:00PM,Washington Commanders,@,Jacksonville Jaguars,16,13,245,0,192,2,0,3,53,-2,False,True
2018-12-17,15,Mon,8:15PM,New Orleans Saints,@,Carolina Panthers,12,9,346,2,247,2,0,3,99,0,False,True
2018-12-22,16,Sat,4:30PM,Tennessee Titans,,Washington Commanders,25,16,291,0,292,2,0,9,-1,-2,True,False
2018-12-22,16,Sat,8:20PM,Baltimore Ravens,@,Los Angeles Chargers,22,10,361,1,198,3,0,12,163,-2,False,True
2018-12-23,16,Sun,8:20PM,Seattle Seahawks,,Kansas City Chiefs,38,31,464,0,419,2,0,7,45,-2,True,False
2018-12-23,16,Sun,4:25PM,New Orleans Saints,,Pittsburgh Steelers,31,28,370,1,429,2,0,3,-59,-1,True,False
2018-12-23,16,Sun,4:05PM,Los Angeles Rams,@,Arizona Cardinals,31,9,461,1,263,0,0,22,198,1,False,True
2018-12-23,16,Sun,4:05PM,Chicago Bears,@,San Francisco 49ers,14,9,325,2,279,1,0,5,46,1,False,True
2018-12-23,16,Sun,1:00PM,Jacksonville Jaguars,@,Miami Dolphins,17,7,244,1,183,2,0,10,61,-1,False,True
2018-12-23,16,Sun,1:00PM,Philadelphia Eagles,,Houston Texans,32,30,519,3,371,1,0,2,148,2,True,False
2018-12-23,16,Sun,1:00PM,Green Bay Packers,@,New York Jets,44,38,540,1,370,0,0,6,170,1,False,True
2018-12-23,16,Sun,1:00PM,Dallas Cowboys,,Tampa Bay Buccaneers,27,20,232,0,383,2,0,7,-151,-2,True,False
2018-12-23,16,Sun,1:00PM,Indianapolis Colts,,New York Giants,28,27,402,1,392,1,0,1,10,0,True,False
2018-12-23,16,Sun,1:00PM,Cleveland Browns,,Cincinnati Bengals,26,18,493,0,209,0,0,8,284,0,True,False
2018-12-23,16,Sun,1:00PM,New England Patriots,,Buffalo Bills,24,12,390,3,289,3,0,12,101,0,True,False
2018-12-23,16,Sun,1:00PM,Atlanta Falcons,@,Carolina Panthers,24,10,427,2,436,4,0,14,-9,-2,False,True
2018-12-23,16,Sun,1:00PM,Minnesota Vikings,@,Detroit Lions,27,9,340,0,223,0,0,18,117,0,False,True
2018-12-24,16,Mon,8:15PM,Las Vegas Raiders,,Denver Broncos,27,14,273,0,300,2,0,13,-27,-2,True,False
2018-12-30,17,Sun,4:25PM,Baltimore Ravens,,Cleveland Browns,26,24,463,1,426,3,0,2,37,-2,True,False
2018-12-30,17,Sun,8:20PM,Indianapolis Colts,@,Tennessee Titans,33,17,436,2,258,3,0,16,178,-1,False,True
2018-12-30,17,Sun,4:25PM,Los Angeles Rams,,San Francisco 49ers,48,32,377,0,391,4,0,16,-14,-4,True,False
2018-12-30,17,Sun,4:25PM,Kansas City Chiefs,,Las Vegas Raiders,35,3,409,1,292,4,0,32,117,-3,True,False
2018-12-30,17,Sun,4:25PM,Los Angeles Chargers,@,Denver Broncos,23,9,276,4,370,4,0,14,-94,0,False,True
2018-12-30,17,Sun,4:25PM,Seattle Seahawks,,Arizona Cardinals,27,24,291,1,198,2,0,3,93,-1,True,False
2018-12-30,17,Sun,4:25PM,Pittsburgh Steelers,,Cincinnati Bengals,16,13,343,1,196,0,0,3,147,1,True,False
2018-12-30,17,Sun,4:25PM,Philadelphia Eagles,@,Washington Commanders,24,0,360,1,89,1,0,24,271,0,False,True
2018-12-30,17,Sun,1:00PM,New England Patriots,,New York Jets,38,3,375,0,239,3,0,35,136,-3,True,False
2018-12-30,17,Sun,1:00PM,Houston Texans,,Jacksonville Jaguars,20,3,342,1,119,2,0,17,223,-1,True,False
2018-12-30,17,Sun,1:00PM,Detroit Lions,@,Green Bay Packers,31,0,402,0,175,1,0,31,227,-1,False,True
2018-12-30,17,Sun,1:00PM,Dallas Cowboys,@,New York Giants,36,35,419,1,441,2,0,1,-22,-1,False,True
2018-12-30,17,Sun,1:00PM,Carolina Panthers,@,New Orleans Saints,33,14,374,0,294,1,0,19,80,-1,False,True
2018-12-30,17,Sun,4:25PM,Chicago Bears,@,Minnesota Vikings,24,10,332,0,164,0,0,14,168,0,False,True
2018-12-30,17,Sun,1:00PM,Buffalo Bills,,Miami Dolphins,42,17,381,1,225,4,0,25,156,-3,True,False
2018-12-30,17,Sun,1:00PM,Atlanta Falcons,@,Tampa Bay Buccaneers,34,32,489,1,433,1,0,2,56,0,False,True
2019-01-05,WildCard,Sat,4:35PM,Indianapolis Colts,@,Houston Texans,21,7,422,1,322,1,0,14,100,0,False,True
2019-01-05,WildCard,Sat,8:15PM,Dallas Cowboys,,Seattle Seahawks,24,22,380,1,299,0,0,2,81,1,True,False
2019-01-06,WildCard,Sun,1:05PM,Los Angeles Chargers,@,Baltimore Ravens,23,17,243,1,229,3,0,6,14,-2,False,True
2019-01-06,WildCard,Sun,4:40PM,Philadelphia Eagles,@,Chicago Bears,16,15,300,2,356,0,0,1,-56,2,False,True
2019-01-12,Division,Sat,8:15PM,Los Angeles Rams,,Dallas Cowboys,30,22,459,0,308,0,0,8,151,0,True,False
2019-01-12,Division,Sat,4:35PM,Kansas City Chiefs,,Indianapolis Colts,31,13,433,1,266,1,0,18,167,0,True,False
2019-01-13,Division,Sun,1:05PM,New England Patriots,,Los Angeles Chargers,41,28,498,0,335,2,0,13,163,-2,True,False
2019-01-13,Division,Sun,4:40PM,New Orleans Saints,,Philadelphia Eagles,20,14,420,1,250,2,0,6,170,-1,True,False
2019-01-20,ConfChamp,Sun,3:05PM,Los Angeles Rams,@,New Orleans Saints,26,23,378,1,290,1,0,3,88,0,False,True
2019-01-20,ConfChamp,Sun,6:40PM,New England Patriots,@,Kansas City Chiefs,37,31,524,2,290,0,0,6,234,2,False,True
2019-02-03,SuperBowl,Sun,6:30PM,New England Patriots,N,Los Angeles Rams,13,3,407,1,260,1,0,10,147,0,False,False
2019-09-05,1,Thu,8:20PM,Green Bay Packers,@,Chicago Bears,10,3,213,0,254,1,0,7,-41,-1,False,True
2019-09-08,1,Sun,8:20PM,New England Patriots,,Pittsburgh Steelers,33,3,465,0,308,1,0,30,157,-1,True,False
2019-09-08,1,Sun,4:25PM,San Francisco 49ers,@,Tampa Bay Buccaneers,31,17,256,2,295,4,0,14,-39,-2,False,True
2019-09-08,1,Sun,4:25PM,Dallas Cowboys,,New York Giants,35,17,494,0,470,2,0,18,24,-2,True,False
2019-09-08,1,Sun,4:25PM,Detroit Lions,@,Arizona Cardinals,27,27,477,2,387,1,1,0,90,1,False,True
2019-09-08,1,Sun,4:05PM,Los Angeles Chargers,,Indianapolis Colts,30,24,435,2,376,0,0,6,59,2,True,False
2019-09-08,1,Sun,4:05PM,Seattle Seahawks,,Cincinnati Bengals,21,20,232,1,429,3,0,1,-197,-2,True,False
2019-09-08,1,Sun,1:00PM,Buffalo Bills,@,New York Jets,17,16,370,4,223,1,0,1,147,3,False,True
2019-09-08,1,Sun,1:00PM,Baltimore Ravens,@,Miami Dolphins,59,10,643,0,200,3,0,49,443,-3,False,True
2019-09-08,1,Sun,1:00PM,Kansas City Chiefs,@,Jacksonville Jaguars,40,26,491,0,428,2,0,14,63,-2,False,True
2019-09-08,1,Sun,1:00PM,Tennessee Titans,@,Cleveland Browns,43,13,339,0,346,3,0,30,-7,-3,False,True
2019-09-08,1,Sun,1:00PM,Los Angeles Rams,@,Carolina Panthers,30,27,349,1,343,3,0,3,6,-2,False,True
2019-09-08,1,Sun,1:00PM,Minnesota Vikings,,Atlanta Falcons,28,12,269,0,345,3,0,16,-76,-3,True,False
2019-09-08,1,Sun,1:00PM,Philadelphia Eagles,,Washington Commanders,32,27,436,0,398,0,0,5,38,0,True,False
2019-09-09,1,Mon,7:10PM,New Orleans Saints,,Houston Texans,30,28,510,1,414,1,0,2,96,0,True,False
2019-09-09,1,Mon,10:20PM,Las Vegas Raiders,,Denver Broncos,24,16,357,0,344,0,0,8,13,0,True,False
2019-09-12,2,Thu,8:20PM,Tampa Bay Buccaneers,@,Carolina Panthers,20,14,289,0,352,1,0,6,-63,-1,False,True
2019-09-15,2,Sun,8:20PM,Atlanta Falcons,,Philadelphia Eagles,24,20,367,3,286,3,0,4,81,0,True,False
2019-09-15,2,Sun,4:25PM,Los Angeles Rams,,New Orleans Saints,27,9,380,1,244,1,0,18,136,0,True,False
2019-09-15,2,Sun,4:25PM,Chicago Bears,@,Denver Broncos,16,14,273,0,372,1,0,2,-99,-1,False,True
2019-09-15,2,Sun,4:05PM,Kansas City Chiefs,@,Las Vegas Raiders,28,10,467,1,307,2,0,18,160,-1,False,True
2019-09-15,2,Sun,1:00PM,Seattle Seahawks,@,Pittsburgh Steelers,28,26,425,2,261,1,0,2,164,1,False,True
2019-09-15,2,Sun,1:00PM,Houston Texans,,Jacksonville Jaguars,13,12,263,0,281,1,0,1,-18,-1,True,False
2019-09-15,2,Sun,1:00PM,New England Patriots,@,Miami Dolphins,43,0,379,1,184,4,0,43,195,-3,False,True
2019-09-15,2,Sun,1:00PM,Detroit Lions,,Los Angeles Chargers,13,10,339,2,424,2,0,3,-85,0,True,False
2019-09-15,2,Sun,1:00PM,Buffalo Bills,@,New York Giants,28,14,388,0,370,2,0,14,18,-2,False,True
2019-09-15,2,Sun,1:00PM,San Francisco 49ers,@,Cincinnati Bengals,41,17,571,1,316,1,0,24,255,0,False,True
2019-09-15,2,Sun,1:00PM,Green Bay Packers,,Minnesota Vikings,21,16,335,2,421,4,0,5,-86,-2,True,False
2019-09-15,2,Sun,1:00PM,Baltimore Ravens,,Arizona Cardinals,23,17,440,0,349,0,0,6,91,0,True,False
2019-09-15,2,Sun,1:00PM,Dallas Cowboys,@,Washington Commanders,31,21,474,1,255,0,0,10,219,1,False,True
2019-09-15,2,Sun,1:00PM,Indianapolis Colts,@,Tennessee Titans,19,17,288,2,243,0,0,2,45,2,False,True
2019-09-16,2,Mon,8:15PM,Cleveland Browns,@,New York Jets,23,3,375,1,262,1,0,20,113,0,False,True
2019-09-19,3,Thu,8:20PM,Jacksonville Jaguars,,Tennessee Titans,20,7,292,0,340,1,0,13,-48,-1,True,False
2019-09-22,3,Sun,4:25PM,San Francisco 49ers,,Pittsburgh Steelers,24,20,436,5,239,2,0,4,197,3,True,False
2019-09-22,3,Sun,4:25PM,New Orleans Saints,@,Seattle Seahawks,33,27,265,1,514,1,0,6,-249,0,False,True
2019-09-22,3,Sun,4:25PM,Houston Texans,@,Los Angeles Chargers,27,20,376,1,366,1,0,7,10,0,False,True
2019-09-22,3,Sun,4:05PM,New York Giants,@,Tampa Bay Buccaneers,32,31,384,2,499,1,0,1,-115,1,False,True
2019-09-22,3,Sun,4:05PM,Carolina Panthers,@,Arizona Cardinals,38,20,413,1,248,2,0,18,165,-1,False,True
2019-09-22,3,Sun,1:00PM,New England Patriots,,New York Jets,30,14,381,2,105,1,0,16,276,1,True,False
2019-09-22,3,Sun,1:00PM,Kansas City Chiefs,,Baltimore Ravens,33,28,503,0,452,0,0,5,51,0,True,False
2019-09-22,3,Sun,1:00PM,Detroit Lions,@,Philadelphia Eagles,27,24,287,0,373,2,0,3,-86,-2,False,True
2019-09-22,3,Sun,8:20PM,Los Angeles Rams,@,Cleveland Browns,20,13,344,3,270,1,0,7,74,2,False,True
2019-09-22,3,Sun,1:00PM,Dallas Cowboys,,Miami Dolphins,31,6,476,1,283,1,0,25,193,0,True,False
2019-09-22,3,Sun,1:00PM,Buffalo Bills,,Cincinnati Bengals,21,17,416,2,306,4,0,4,110,-2,True,False
2019-09-22,3,Sun,1:00PM,Indianapolis Colts,,Atlanta Falcons,27,24,379,0,397,1,0,3,-18,-1,True,False
2019-09-22,3,Sun,1:00PM,Minnesota Vikings,,Las Vegas Raiders,34,14,385,0,302,1,0,20,83,-1,True,False
2019-09-22,3,Sun,1:00PM,Green Bay Packers,,Denver Broncos,27,16,312,0,310,3,0,11,2,-3,True,False
2019-09-23,3,Mon,8:15PM,Chicago Bears,@,Washington Commanders,31,15,298,1,356,5,0,16,-58,-4,False,True
2019-09-26,4,Thu,8:20PM,Philadelphia Eagles,@,Green Bay Packers,34,27,336,0,491,2,0,7,-155,-2,False,True
2019-09-29,4,Sun,1:00PM,Tennessee Titans,@,Atlanta Falcons,24,10,365,0,422,1,0,14,-57,-1,False,True
2019-09-29,4,Sun,8:20PM,New Orleans Saints,,Dallas Cowboys,12,10,266,1,257,3,0,2,9,-2,True,False
2019-09-29,4,Sun,4:25PM,Jacksonville Jaguars,@,Denver Broncos,26,24,455,0,371,1,0,2,84,-1,False,True
2019-09-29,4,Sun,4:05PM,Tampa Bay Buccaneers,@,Los Angeles Rams,55,40,464,1,518,4,0,15,-54,-3,False,True
2019-09-29,4,Sun,4:05PM,Seattle Seahawks,@,Arizona Cardinals,27,10,340,0,321,1,0,17,19,-1,False,True
2019-09-29,4,Sun,1:00PM,New York Giants,,Washington Commanders,24,3,389,4,176,4,0,21,213,0,True,False
2019-09-29,4,Sun,4:25PM,Chicago Bears,,Minnesota Vikings,16,6,269,0,222,2,0,10,47,-2,True,False
2019-09-29,4,Sun,1:00PM,Kansas City Chiefs,@,Detroit Lions,34,30,438,3,447,2,0,4,-9,1,False,True
2019-09-29,4,Sun,1:00PM,Las Vegas Raiders,@,Indianapolis Colts,31,24,377,1,346,2,0,7,31,-1,False,True
2019-09-29,4,Sun,1:00PM,Cleveland Browns,@,Baltimore Ravens,40,25,530,1,395,3,0,15,135,-2,False,True
2019-09-29,4,Sun,1:00PM,Carolina Panthers,@,Houston Texans,16,10,297,3,264,2,0,6,33,1,False,True
2019-09-29,4,Sun,1:00PM,New England Patriots,@,Buffalo Bills,16,10,224,1,375,4,0,6,-151,-3,False,True
2019-09-29,4,Sun,1:00PM,Los Angeles Chargers,@,Miami Dolphins,30,10,390,0,233,1,0,20,157,-1,False,True
2019-09-30,4,Mon,8:15PM,Pittsburgh Steelers,,Cincinnati Bengals,27,3,326,1,175,2,0,24,151,-1,True,False
2019-10-03,5,Thu,8:20PM,Seattle Seahawks,,Los Angeles Rams,30,29,429,1,477,2,0,1,-48,-1,True,False
2019-10-06,5,Sun,8:20PM,Indianapolis Colts,@,Kansas City Chiefs,19,13,331,1,324,1,0,6,7,0,False,True
2019-10-06,5,Sun,4:25PM,Green Bay Packers,@,Dallas Cowboys,34,24,335,0,563,3,0,10,-228,-3,False,True
2019-10-06,5,Sun,4:05PM,Denver Broncos,@,Los Angeles Chargers,20,13,350,2,246,3,0,7,104,-1,False,True
2019-10-06,5,Sun,1:00PM,Baltimore Ravens,@,Pittsburgh Steelers,26,23,277,3,269,2,0,3,8,1,False,True
2019-10-06,5,Sun,1:00PM,New Orleans Saints,,Tampa Bay Buccaneers,31,24,457,1,252,0,0,7,205,1,True,False
2019-10-06,5,Sun,1:00PM,New England Patriots,@,Washington Commanders,33,7,442,1,223,2,0,26,219,-1,False,True
2019-10-06,5,Sun,1:00PM,Arizona Cardinals,@,Cincinnati Bengals,26,23,514,0,370,0,0,3,144,0,False,True
2019-10-06,5,Sun,1:00PM,Las Vegas Raiders,,Chicago Bears,24,21,398,2,236,2,0,3,162,0,True,False
2019-10-06,5,Sun,1:00PM,Carolina Panthers,,Jacksonville Jaguars,34,27,445,0,507,3,0,7,-62,-3,True,False
2019-10-06,5,Sun,1:00PM,Buffalo Bills,@,Tennessee Titans,14,7,313,1,252,0,0,7,61,1,False,True
2019-10-06,5,Sun,1:00PM,Houston Texans,,Atlanta Falcons,53,32,592,1,373,1,0,21,219,0,True,False
2019-10-06,5,Sun,1:00PM,Philadelphia Eagles,,New York Jets,31,6,265,1,128,3,0,25,137,-2,True,False
2019-10-06,5,Sun,1:00PM,Minnesota Vikings,@,New York Giants,28,10,490,1,211,1,0,18,279,0,False,True
2019-10-07,5,Mon,8:15PM,San Francisco 49ers,,Cleveland Browns,31,3,446,0,180,4,0,28,266,-4,True,False
2019-10-10,6,Thu,8:20PM,New England Patriots,,New York Giants,35,14,427,2,213,4,0,21,214,-2,True,False
2019-10-13,6,Sun,8:20PM,Pittsburgh Steelers,@,Los Angeles Chargers,24,17,256,1,348,3,0,7,-92,-2,False,True
2019-10-13,6,Sun,4:25PM,Denver Broncos,,Tennessee Titans,16,0,270,1,204,3,0,16,66,-2,True,False
2019-10-13,6,Sun,4:25PM,New York Jets,,Dallas Cowboys,24,22,382,1,399,0,0,2,-17,1,True,False
2019-10-13,6,Sun,4:05PM,San Francisco 49ers,@,Los Angeles Rams,20,7,331,2,157,1,0,13,174,1,False,True
2019-10-13,6,Sun,4:05PM,Arizona Cardinals,,Atlanta Falcons,34,33,442,0,444,0,0,1,-2,0,True,False
2019-10-13,6,Sun,1:00PM,New Orleans Saints,@,Jacksonville Jaguars,13,6,326,0,226,1,0,7,100,-1,False,True
2019-10-13,6,Sun,1:00PM,Houston Texans,@,Kansas City Chiefs,31,24,472,3,309,2,0,7,163,1,False,True
2019-10-13,6,Sun,1:00PM,Seattle Seahawks,@,Cleveland Browns,32,28,454,1,406,4,0,4,48,-3,False,True
2019-10-13,6,Sun,1:00PM,Baltimore Ravens,,Cincinnati Bengals,23,17,497,1,250,1,0,6,247,0,True,False
2019-10-13,6,Sun,1:00PM,Washington Commanders,@,Miami Dolphins,17,16,311,0,271,2,0,1,40,-2,False,True
2019-10-13,6,Sun,9:30AM,Carolina Panthers,@,Tampa Bay Buccaneers,37,26,268,1,407,7,0,11,-139,-6,False,True
2019-10-13,6,Sun,1:00PM,Minnesota Vikings,,Philadelphia Eagles,38,20,447,2,400,3,0,18,47,-1,True,False
2019-10-14,6,Mon,8:15PM,Green Bay Packers,,Detroit Lions,23,22,447,3,299,0,0,1,148,3,True,False
2019-10-17,7,Thu,8:20PM,Kansas City Chiefs,@,Denver Broncos,30,6,271,0,205,1,0,24,66,-1,False,True
2019-10-20,7,Sun,1:00PM,Arizona Cardinals,@,New York Giants,27,21,245,0,263,3,0,6,-18,-3,False,True
2019-10-20,7,Sun,4:25PM,New Orleans Saints,@,Chicago Bears,36,25,424,0,252,2,0,11,172,-2,False,True
2019-10-20,7,Sun,4:05PM,Tennessee Titans,,Los Angeles Chargers,23,20,403,1,365,1,0,3,38,0,True,False
2019-10-20,7,Sun,1:00PM,Green Bay Packers,,Las Vegas Raiders,42,24,481,0,484,2,0,18,-3,-2,True,False
2019-10-20,7,Sun,1:00PM,Jacksonville Jaguars,@,Cincinnati Bengals,27,17,460,0,291,4,0,10,169,-4,False,True
2019-10-20,7,Sun,4:25PM,Baltimore Ravens,@,Seattle Seahawks,30,16,340,0,347,2,0,14,-7,-2,False,True
2019-10-20,7,Sun,8:20PM,Dallas Cowboys,,Philadelphia Eagles,37,10,402,1,283,4,0,27,119,-3,True,False
2019-10-20,7,Sun,1:00PM,Los Angeles Rams,@,Atlanta Falcons,37,10,381,0,224,3,0,27,157,-3,False,True
2019-10-20,7,Sun,1:00PM,Indianapolis Colts,,Houston Texans,30,23,383,1,391,2,0,7,-8,-1,True,False
2019-10-20,7,Sun,1:00PM,Buffalo Bills,,Miami Dolphins,31,21,305,0,381,2,0,10,-76,-2,True,False
2019-10-20,7,Sun,1:00PM,San Francisco 49ers,@,Washington Commanders,9,0,283,1,154,1,0,9,129,0,False,True
2019-10-20,7,Sun,1:00PM,Minnesota Vikings,@,Detroit Lions,42,30,504,0,433,1,0,12,71,-1,False,True
2019-10-21,7,Mon,8:15PM,New England Patriots,@,New York Jets,33,0,323,1,154,6,0,33,169,-5,False,True
2019-10-24,8,Thu,8:20PM,Minnesota Vikings,,Washington Commanders,19,9,434,1,216,2,0,10,218,-1,True,False
2019-10-27,8,Sun,4:25PM,Houston Texans,,Las Vegas Raiders,27,24,388,0,378,0,0,3,10,0,True,False
2019-10-27,8,Sun,4:25PM,New England Patriots,,Cleveland Browns,27,13,318,0,310,3,0,14,8,-3,True,False
2019-10-27,8,Sun,4:05PM,San Francisco 49ers,,Carolina Panthers,51,13,388,1,230,3,0,38,158,-2,True,False
2019-10-27,8,Sun,1:00PM,Tennessee Titans,,Tampa Bay Buccaneers,27,23,246,1,389,4,0,4,-143,-3,True,False
2019-10-27,8,Sun,1:00PM,Jacksonville Jaguars,,New York Jets,29,15,389,1,213,3,0,14,176,-2,True,False
2019-10-27,8,Sun,8:20PM,Green Bay Packers,@,Kansas City Chiefs,31,24,374,0,337,1,0,7,37,-1,False,True
2019-10-27,8,Sun,1:00PM,Los Angeles Rams,,Cincinnati Bengals,24,10,470,0,401,0,0,14,69,0,True,False
2019-10-27,8,Sun,1:00PM,Seattle Seahawks,@,Atlanta Falcons,27,20,322,0,510,3,0,7,-188,-3,False,True
2019-10-27,8,Sun,1:00PM,Detroit Lions,,New York Giants,31,26,375,2,370,1,0,5,5,1,True,False
2019-10-27,8,Sun,1:00PM,Indianapolis Colts,,Denver Broncos,15,13,318,1,279,0,0,2,39,1,True,False
2019-10-27,8,Sun,1:00PM,Los Angeles Chargers,@,Chicago Bears,17,16,231,1,388,2,0,1,-157,-1,False,True
2019-10-27,8,Sun,1:00PM,Philadelphia Eagles,@,Buffalo Bills,31,13,371,1,253,1,0,18,118,0,False,True
2019-10-27,8,Sun,1:00PM,New Orleans Saints,,Arizona Cardinals,31,9,510,1,237,0,0,22,273,1,True,False
2019-10-28,8,Mon,8:15PM,Pittsburgh Steelers,,Miami Dolphins,27,14,394,1,230,4,0,13,164,-3,True,False
2019-10-31,9,Thu,8:20PM,San Francisco 49ers,@,Arizona Cardinals,28,25,411,0,357,0,0,3,54,0,False,True
2019-11-03,9,Sun,8:20PM,Baltimore Ravens,,New England Patriots,37,20,372,2,342,2,0,17,30,0,True,False
2019-11-03,9,Sun,4:05PM,Seattle Seahawks,,Tampa Bay Buccaneers,40,34,492,1,418,1,0,6,74,0,True,False
2019-11-03,9,Sun,4:05PM,Las Vegas Raiders,,Detroit Lions,31,24,450,0,473,2,0,7,-23,-2,True,False
2019-11-03,9,Sun,1:00PM,Kansas City Chiefs,,Minnesota Vikings,26,23,377,1,308,0,0,3,69,1,True,False
2019-11-03,9,Sun,1:00PM,Carolina Panthers,,Tennessee Titans,30,20,370,1,431,3,0,10,-61,-2,True,False
2019-11-03,9,Sun,1:00PM,Pittsburgh Steelers,,Indianapolis Colts,26,24,273,2,328,3,0,2,-55,-1,True,False
2019-11-03,9,Sun,1:00PM,Philadelphia Eagles,,Chicago Bears,22,14,373,0,164,1,0,8,209,-1,True,False
2019-11-03,9,Sun,1:00PM,Buffalo Bills,,Washington Commanders,24,9,268,0,243,0,0,15,25,0,True,False
2019-11-03,9,Sun,9:30AM,Houston Texans,@,Jacksonville Jaguars,26,3,410,1,356,4,0,23,54,-3,False,True
2019-11-03,9,Sun,4:25PM,Los Angeles Chargers,,Green Bay Packers,26,11,442,0,184,0,0,15,258,0,True,False
2019-11-03,9,Sun,1:00PM,Miami Dolphins,,New York Jets,26,18,316,0,321,1,0,8,-5,-1,True,False
2019-11-03,9,Sun,4:25PM,Denver Broncos,,Cleveland Browns,24,19,302,1,351,0,0,5,-49,1,True,False
2019-11-04,9,Mon,8:15PM,Dallas Cowboys,@,New York Giants,37,18,429,2,271,3,0,19,158,-1,False,True
2019-11-07,10,Thu,8:20PM,Las Vegas Raiders,,Los Angeles Chargers,26,24,278,0,315,3,0,2,-37,-3,True,False
2019-11-10,10,Sun,1:00PM,Cleveland Browns,,Buffalo Bills,19,16,368,0,344,0,0,3,24,0,True,False
2019-11-10,10,Sun,1:00PM,Atlanta Falcons,@,New Orleans Saints,26,9,317,1,310,0,0,17,7,1,False,True
2019-11-10,10,Sun,8:20PM,Minnesota Vikings,@,Dallas Cowboys,28,24,364,0,443,1,0,4,-79,-1,False,True
2019-11-10,10,Sun,4:25PM,Green Bay Packers,,Carolina Panthers,24,16,388,0,401,2,0,8,-13,-2,True,False
2019-11-10,10,Sun,4:05PM,Miami Dolphins,@,Indianapolis Colts,16,12,229,2,300,3,0,4,-71,-1,False,True
2019-11-10,10,Sun,4:25PM,Pittsburgh Steelers,,Los Angeles Rams,17,12,273,2,306,4,0,5,-33,-2,True,False
2019-11-10,10,Sun,1:00PM,Tennessee Titans,,Kansas City Chiefs,35,32,371,1,530,1,0,3,-159,0,True,False
2019-11-10,10,Sun,1:00PM,Tampa Bay Buccaneers,,Arizona Cardinals,30,27,457,3,417,2,0,3,40,1,True,False
2019-11-10,10,Sun,1:00PM,Baltimore Ravens,@,Cincinnati Bengals,49,13,379,1,307,3,0,36,72,-2,False,True
2019-11-10,10,Sun,1:00PM,Chicago Bears,,Detroit Lions,20,13,226,0,357,1,0,7,-131,-1,True,False
2019-11-10,10,Sun,1:00PM,New York Jets,,New York Giants,34,27,294,0,281,2,0,7,13,-2,True,False
2019-11-11,10,Mon,8:15PM,Seattle Seahawks,@,San Francisco 49ers,27,24,336,4,302,3,0,3,34,1,False,True
2019-11-14,11,Thu,8:20PM,Cleveland Browns,,Pittsburgh Steelers,21,7,293,0,236,4,0,14,57,-4,True,False
2019-11-17,11,Sun,4:05PM,San Francisco 49ers,,Arizona Cardinals,36,26,442,2,266,2,0,10,176,0,True,False
2019-11-17,11,Sun,8:20PM,Los Angeles Rams,,Chicago Bears,17,7,283,2,267,1,0,10,16,1,True,False
2019-11-17,11,Sun,4:25PM,New England Patriots,@,Philadelphia Eagles,17,10,298,0,255,1,0,7,43,-1,False,True
2019-11-17,11,Sun,4:25PM,Las Vegas Raiders,,Cincinnati Bengals,17,10,386,2,246,2,0,7,140,0,True,False
2019-11-17,11,Sun,1:00PM,New York Jets,@,Washington Commanders,34,17,400,2,225,1,0,17,175,1,False,True
2019-11-17,11,Sun,1:00PM,Indianapolis Colts,,Jacksonville Jaguars,33,13,389,2,308,1,0,20,81,1,True,False
2019-11-17,11,Sun,1:00PM,Baltimore Ravens,,Houston Texans,41,7,491,0,232,2,0,34,259,-2,True,False
2019-11-17,11,Sun,1:00PM,Minnesota Vikings,,Denver Broncos,27,23,321,2,394,1,0,4,-73,1,True,False
2019-11-17,11,Sun,1:00PM,Dallas Cowboys,@,Detroit Lions,35,27,509,1,312,0,0,8,197,1,False,True
2019-11-17,11,Sun,1:00PM,Buffalo Bills,@,Miami Dolphins,37,20,424,0,303,1,0,17,121,-1,False,True
2019-11-17,11,Sun,1:00PM,New Orleans Saints,@,Tampa Bay Buccaneers,34,17,328,0,334,4,0,17,-6,-4,False,True
2019-11-17,11,Sun,1:00PM,Atlanta Falcons,@,Carolina Panthers,29,3,349,0,347,4,0,26,2,-4,False,True
2019-11-18,11,Mon,8:15PM,Kansas City Chiefs,@,Los Angeles Chargers,24,17,310,1,438,4,0,7,-128,-3,False,True
2019-11-21,12,Thu,8:20PM,Houston Texans,,Indianapolis Colts,20,17,396,1,296,0,0,3,100,1,True,False
2019-11-24,12,Sun,1:00PM,Washington Commanders,,Detroit Lions,19,16,230,2,364,4,0,3,-134,-2,True,False
2019-11-24,12,Sun,1:00PM,Buffalo Bills,,Denver Broncos,20,3,424,1,134,1,0,17,290,0,True,False
2019-11-24,12,Sun,1:00PM,Tampa Bay Buccaneers,@,Atlanta Falcons,35,22,446,2,337,2,0,13,109,0,False,True
2019-11-24,12,Sun,4:25PM,New England Patriots,,Dallas Cowboys,13,9,282,0,321,1,0,4,-39,-1,True,False
2019-11-24,12,Sun,4:05PM,Tennessee Titans,,Jacksonville Jaguars,42,20,471,2,369,1,0,22,102,1,True,False
2019-11-24,12,Sun,1:00PM,Seattle Seahawks,@,Philadelphia Eagles,17,9,348,2,344,5,0,8,4,-3,False,True
2019-11-24,12,Sun,8:20PM,San Francisco 49ers,,Green Bay Packers,37,8,339,0,198,1,0,29,141,-1,True,False
2019-11-24,12,Sun,1:00PM,Cleveland Browns,,Miami Dolphins,41,24,467,1,284,2,0,17,183,-1,True,False
2019-11-24,12,Sun,1:00PM,Pittsburgh Steelers,@,Cincinnati Bengals,16,10,338,1,244,2,0,6,94,-1,False,True
2019-11-24,12,Sun,1:00PM,Chicago Bears,,New York Giants,19,14,335,2,243,1,0,5,92,1,True,False
2019-11-24,12,Sun,1:00PM,New Orleans Saints,,Carolina Panthers,34,31,418,1,351,1,0,3,67,0,True,False
2019-11-24,12,Sun,1:00PM,New York Jets,,Las Vegas Raiders,34,3,401,1,208,2,0,31,193,-1,True,False
2019-11-25,12,Mon,8:15PM,Baltimore Ravens,@,Los Angeles Rams,45,6,480,0,221,2,0,39,259,-2,False,True
2019-11-28,13,Thu,12:30PM,Chicago Bears,@,Detroit Lions,24,20,419,1,364,1,0,4,55,0,False,True
2019-11-28,13,Thu,4:30PM,Buffalo Bills,@,Dallas Cowboys,26,15,356,0,426,2,0,11,-70,-2,False,True
2019-11-28,13,Thu,8:20PM,New Orleans Saints,@,Atlanta Falcons,26,18,279,0,348,3,0,8,-69,-3,False,True
2019-12-01,13,Sun,4:05PM,Los Angeles Rams,@,Arizona Cardinals,34,7,549,0,198,1,0,27,351,-1,False,True
2019-12-01,13,Sun,8:20PM,Houston Texans,,New England Patriots,28,22,276,0,448,1,0,6,-172,-1,True,False
2019-12-01,13,Sun,4:25PM,Kansas City Chiefs,,Las Vegas Raiders,40,9,259,0,332,3,0,31,-73,-3,True,False
2019-12-01,13,Sun,4:25PM,Denver Broncos,,Los Angeles Chargers,23,20,218,1,359,2,0,3,-141,-1,True,False
2019-12-01,13,Sun,1:00PM,Baltimore Ravens,,San Francisco 49ers,20,17,283,1,331,1,0,3,-48,0,True,False
2019-12-01,13,Sun,1:00PM,Tennessee Titans,@,Indianapolis Colts,31,17,292,2,391,3,0,14,-99,-1,False,True
2019-12-01,13,Sun,1:00PM,Tampa Bay Buccaneers,@,Jacksonville Jaguars,28,11,315,1,242,4,0,17,73,-3,False,True
2019-12-01,13,Sun,1:00PM,Green Bay Packers,@,New York Giants,31,13,322,0,335,3,0,18,-13,-3,False,True
2019-12-01,13,Sun,1:00PM,Pittsburgh Steelers,,Cleveland Browns,20,13,323,1,279,2,0,7,44,-1,True,False
2019-12-01,13,Sun,1:00PM,Cincinnati Bengals,,New York Jets,22,6,277,0,271,0,0,16,6,0,True,False
2019-12-01,13,Sun,1:00PM,Washington Commanders,@,Carolina Panthers,29,21,362,0,278,2,0,8,84,-2,False,True
2019-12-01,13,Sun,1:00PM,Miami Dolphins,,Philadelphia Eagles,37,31,409,1,386,1,0,6,23,0,True,False
2019-12-02,13,Mon,8:15PM,Seattle Seahawks,,Minnesota Vikings,37,30,444,2,354,3,0,7,90,-1,True,False
2019-12-05,14,Thu,8:20PM,Chicago Bears,,Dallas Cowboys,31,24,382,2,408,0,0,7,-26,2,True,False
2019-12-08,14,Sun,1:00PM,San Francisco 49ers,@,New Orleans Saints,48,46,516,1,465,1,0,2,51,0,False,True
2019-12-08,14,Sun,4:25PM,Tennessee Titans,@,Las Vegas Raiders,42,21,552,1,355,1,0,21,197,0,False,True
2019-12-08,14,Sun,4:25PM,Kansas City Chiefs,@,New England Patriots,23,16,346,2,278,1,0,7,68,1,False,True
2019-12-08,14,Sun,4:25PM,Pittsburgh Steelers,@,Arizona Cardinals,23,17,275,2,236,3,0,6,39,-1,False,True
2019-12-08,14,Sun,4:05PM,Los Angeles Chargers,@,Jacksonville Jaguars,45,10,525,0,252,0,0,35,273,0,False,True
2019-12-08,14,Sun,1:00PM,New York Jets,,Miami Dolphins,22,21,374,1,362,1,0,1,12,0,True,False
2019-12-08,14,Sun,8:20PM,Los Angeles Rams,,Seattle Seahawks,28,12,455,2,308,1,0,16,147,1,True,False
2019-12-08,14,Sun,1:00PM,Minnesota Vikings,,Detroit Lions,20,7,354,0,231,2,0,13,123,-2,True,False
2019-12-08,14,Sun,1:00PM,Denver Broncos,@,Houston Texans,38,24,391,1,414,3,0,14,-23,-2,False,True
2019-12-08,14,Sun,1:00PM,Tampa Bay Buccaneers,,Indianapolis Colts,38,35,542,4,309,1,0,3,233,3,True,False
2019-12-08,14,Sun,1:00PM,Cleveland Browns,,Cincinnati Bengals,27,19,333,2,451,1,0,8,-118,1,True,False
2019-12-08,14,Sun,1:00PM,Baltimore Ravens,@,Buffalo Bills,24,17,257,1,209,1,0,7,48,0,False,True
2019-12-08,14,Sun,1:00PM,Atlanta Falcons,,Carolina Panthers,40,20,461,0,345,4,0,20,116,-4,True,False
2019-12-08,14,Sun,1:00PM,Green Bay Packers,,Washington Commanders,20,15,341,1,262,1,0,5,79,0,True,False
2019-12-09,14,Mon,8:15PM,Philadelphia Eagles,,New York Giants,23,17,418,1,255,0,0,6,163,1,True,False
2019-12-12,15,Thu,8:20PM,Baltimore Ravens,,New York Jets,42,21,430,0,310,2,0,21,120,-2,True,False
2019-12-15,15,Sun,8:20PM,Buffalo Bills,@,Pittsburgh Steelers,17,10,261,2,229,5,0,7,32,-3,False,True
2019-12-15,15,Sun,4:25PM,Dallas Cowboys,,Los Angeles Rams,44,21,475,0,289,1,0,23,186,-1,True,False
2019-12-15,15,Sun,4:25PM,Atlanta Falcons,@,San Francisco 49ers,29,22,290,1,313,2,0,7,-23,-1,False,True
2019-12-15,15,Sun,4:05PM,Minnesota Vikings,@,Los Angeles Chargers,39,10,344,1,345,7,0,29,-1,-6,False,True
2019-12-15,15,Sun,4:05PM,Jacksonville Jaguars,@,Las Vegas Raiders,20,16,262,0,364,0,0,4,-102,0,False,True
2019-12-15,15,Sun,4:05PM,Arizona Cardinals,,Cleveland Browns,38,24,445,1,393,2,0,14,52,-1,True,False
2019-12-15,15,Sun,1:00PM,Tampa Bay Buccaneers,@,Detroit Lions,38,17,495,1,295,3,0,21,200,-2,False,True
2019-12-15,15,Sun,1:00PM,New York Giants,,Miami Dolphins,36,20,412,3,384,1,0,16,28,2,True,False
2019-12-15,15,Sun,1:00PM,Houston Texans,@,Tennessee Titans,24,21,374,2,432,1,0,3,-58,1,False,True
2019-12-15,15,Sun,1:00PM,Kansas City Chiefs,,Denver Broncos,23,3,419,1,251,1,0,20,168,0,True,False
2019-12-15,15,Sun,1:00PM,New England Patriots,@,Cincinnati Bengals,34,13,291,0,315,5,0,21,-24,-5,False,True
2019-12-15,15,Sun,1:00PM,Green Bay Packers,,Chicago Bears,21,13,292,0,415,3,0,8,-123,-3,True,False
2019-12-15,15,Sun,1:00PM,Seattle Seahawks,@,Carolina Panthers,30,24,428,1,414,3,0,6,14,-2,False,True
2019-12-15,15,Sun,1:00PM,Philadelphia Eagles,@,Washington Commanders,37,27,415,1,352,1,0,10,63,0,False,True
2019-12-16,15,Mon,8:15PM,New Orleans Saints,,Indianapolis Colts,34,7,424,0,205,0,0,27,219,0,True,False
2019-12-21,16,Sat,8:15PM,San Francisco 49ers,,Los Angeles Rams,34,31,334,2,395,1,0,3,-61,1,True,False
2019-12-21,16,Sat,1:00PM,Houston Texans,@,Tampa Bay Buccaneers,23,20,229,2,435,5,0,3,-206,-3,False,True
2019-12-21,16,Sat,4:30PM,New England Patriots,,Buffalo Bills,24,17,414,1,268,0,0,7,146,1,True,False
2019-12-22,16,Sun,1:00PM,Atlanta Falcons,,Jacksonville Jaguars,24,12,518,2,288,1,0,12,230,1,True,False
2019-12-22,16,Sun,8:20PM,Kansas City Chiefs,@,Chicago Bears,26,3,350,0,234,0,0,23,116,0,False,True
2019-12-22,16,Sun,4:25PM,Arizona Cardinals,@,Seattle Seahawks,27,13,412,0,224,1,0,14,188,-1,False,True
2019-12-22,16,Sun,4:05PM,Las Vegas Raiders,@,Los Angeles Chargers,24,17,366,0,284,0,0,7,82,0,False,True
2019-12-22,16,Sun,4:05PM,Denver Broncos,,Detroit Lions,27,17,348,0,191,0,0,10,157,0,True,False
2019-12-22,16,Sun,4:25PM,Philadelphia Eagles,,Dallas Cowboys,17,9,431,0,311,1,0,8,120,-1,True,False
2019-12-22,16,Sun,1:00PM,New York Giants,@,Washington Commanders,41,35,552,0,361,0,0,6,191,0,False,True
2019-12-22,16,Sun,1:00PM,New Orleans Saints,@,Tennessee Titans,38,28,377,0,397,1,0,10,-20,-1,False,True
2019-12-22,16,Sun,1:00PM,Baltimore Ravens,@,Cleveland Browns,31,15,481,1,241,1,0,16,240,0,False,True
2019-12-22,16,Sun,1:00PM,Miami Dolphins,,Cincinnati Bengals,38,35,502,1,430,1,0,3,72,0,True,False
2019-12-22,16,Sun,1:00PM,Indianapolis Colts,,Carolina Panthers,38,6,324,0,286,3,0,32,38,-3,True,False
2019-12-22,16,Sun,1:00PM,New York Jets,,Pittsburgh Steelers,16,10,259,1,260,2,0,6,-1,-1,True,False
2019-12-23,16,Mon,8:15PM,Green Bay Packers,@,Minnesota Vikings,23,10,383,3,139,1,0,13,244,2,False,True
2019-12-29,17,Sun,4:25PM,Dallas Cowboys,,Washington Commanders,47,16,517,1,271,2,0,31,246,-1,True,False
2019-12-29,17,Sun,8:20PM,San Francisco 49ers,@,Seattle Seahawks,26,21,398,0,348,0,0,5,50,0,False,True
2019-12-29,17,Sun,4:25PM,Baltimore Ravens,,Pittsburgh Steelers,28,10,304,2,168,2,0,18,136,0,True,False
2019-12-29,17,Sun,4:25PM,Philadelphia Eagles,@,New York Giants,34,17,400,0,397,2,0,17,3,-2,False,True
2019-12-29,17,Sun,4:25PM,Tennessee Titans,@,Houston Texans,35,14,467,0,301,1,0,21,166,-1,False,True
2019-12-29,17,Sun,4:25PM,Denver Broncos,,Las Vegas Raiders,16,15,238,1,477,1,0,1,-239,0,True,False
2019-12-29,17,Sun,4:25PM,Los Angeles Rams,,Arizona Cardinals,31,24,424,0,393,5,0,7,31,-5,True,False
2019-12-29,17,Sun,1:00PM,Miami Dolphins,@,New England Patriots,27,24,389,0,352,2,0,3,37,-2,False,True
2019-12-29,17,Sun,4:25PM,Jacksonville Jaguars,,Indianapolis Colts,38,20,353,1,275,2,0,18,78,-1,True,False
2019-12-29,17,Sun,1:00PM,Kansas City Chiefs,,Los Angeles Chargers,31,21,336,1,366,2,0,10,-30,-1,True,False
2019-12-29,17,Sun,1:00PM,Green Bay Packers,@,Detroit Lions,23,20,432,1,305,1,0,3,127,0,False,True
2019-12-29,17,Sun,1:00PM,Cincinnati Bengals,,Cleveland Browns,33,23,361,1,313,3,0,10,48,-2,True,False
2019-12-29,17,Sun,1:00PM,Chicago Bears,@,Minnesota Vikings,21,19,337,1,300,3,0,2,37,-2,False,True
2019-12-29,17,Sun,1:00PM,New Orleans Saints,@,Carolina Panthers,42,10,379,0,329,3,0,32,50,-3,False,True
2019-12-29,17,Sun,1:00PM,New York Jets,@,Buffalo Bills,13,6,271,1,309,3,0,7,-38,-2,False,True
2019-12-29,17,Sun,1:00PM,Atlanta Falcons,@,Tampa Bay Buccaneers,28,22,373,1,329,3,0,6,44,-2,False,True
2020-01-04,WildCard,Sat,4:35PM,Houston Texans,,Buffalo Bills,22,19,360,1,425,1,0,3,-65,0,True,False
2020-01-04,WildCard,Sat,8:15PM,Tennessee Titans,@,New England Patriots,20,13,272,1,307,2,0,7,-35,-1,False,True
2020-01-05,WildCard,Sun,1:05PM,Minnesota Vikings,@,New Orleans Saints,26,20,362,1,324,2,0,6,38,-1,False,True
2020-01-05,WildCard,Sun,4:40PM,Seattle Seahawks,@,Philadelphia Eagles,17,9,382,0,282,0,0,8,100,0,False,True
2020-01-11,Division,Sat,4:35PM,San Francisco 49ers,,Minnesota Vikings,27,10,308,2,147,2,0,17,161,0,True,False
2020-01-11,Division,Sat,8:15PM,Tennessee Titans,@,Baltimore Ravens,28,12,300,0,530,3,0,16,-230,-3,False,True
2020-01-12,Division,Sun,3:05PM,Kansas City Chiefs,,Houston Texans,51,31,434,1,442,1,0,20,-8,0,True,False
2020-01-12,Division,Sun,6:40PM,Green Bay Packers,,Seattle Seahawks,28,23,344,0,375,0,0,5,-31,0,True,False
2020-01-19,ConfChamp,Sun,3:05PM,Kansas City Chiefs,,Tennessee Titans,35,24,404,0,295,0,0,11,109,0,True,False
2020-01-19,ConfChamp,Sun,6:40PM,San Francisco 49ers,,Green Bay Packers,37,20,354,0,358,3,0,17,-4,-3,True,False
2020-02-02,SuperBowl,Sun,6:30PM,Kansas City Chiefs,N,San Francisco 49ers,31,20,397,2,351,2,0,11,46,0,False,False
2020-09-10,1,Thu,8:20PM,Kansas City Chiefs,,Houston Texans,34,20,369,0,360,1,0,14,9,-1,True,False
2020-09-13,1,Sun,1:00PM,Green Bay Packers,@,Minnesota Vikings,43,34,522,0,382,1,0,9,140,-1,False,True
2020-09-13,1,Sun,1:00PM,Jacksonville Jaguars,,Indianapolis Colts,27,20,241,0,445,2,0,7,-204,-2,True,False
2020-09-13,1,Sun,1:00PM,Baltimore Ravens,,Cleveland Browns,38,6,381,1,306,3,0,32,75,-2,True,False
2020-09-13,1,Sun,1:00PM,Chicago Bears,@,Detroit Lions,27,23,363,0,426,1,0,4,-63,-1,False,True
2020-09-13,1,Sun,1:00PM,Las Vegas Raiders,@,Carolina Panthers,34,30,372,0,388,0,0,4,-16,0,False,True
2020-09-13,1,Sun,1:00PM,Buffalo Bills,,New York Jets,27,17,404,2,254,2,0,10,150,0,True,False
2020-09-13,1,Sun,1:00PM,Seattle Seahawks,@,Atlanta Falcons,38,25,383,0,506,2,0,13,-123,-2,False,True
2020-09-13,1,Sun,8:20PM,Los Angeles Rams,,Dallas Cowboys,20,17,422,1,380,0,0,3,42,1,True,False
2020-09-13,1,Sun,4:05PM,Los Angeles Chargers,@,Cincinnati Bengals,16,13,362,0,295,2,0,3,67,-2,False,True
2020-09-13,1,Sun,4:25PM,Arizona Cardinals,@,San Francisco 49ers,24,20,404,1,366,0,0,4,38,1,False,True
2020-09-13,1,Sun,4:25PM,New Orleans Saints,,Tampa Bay Buccaneers,34,23,271,0,310,3,0,11,-39,-3,True,False
2020-09-13,1,Sun,1:00PM,New England Patriots,,Miami Dolphins,21,11,357,1,269,3,0,10,88,-2,True,False
2020-09-13,1,Sun,1:00PM,Washington Commanders,,Philadelphia Eagles,27,17,239,0,265,3,0,10,-26,-3,True,False
2020-09-14,1,Mon,7:15PM,Pittsburgh Steelers,@,New York Giants,26,16,349,1,291,2,0,10,58,-1,False,True
2020-09-14,1,Mon,10:10PM,Tennessee Titans,@,Denver Broncos,16,14,377,0,323,1,0,2,54,-1,False,True
2020-09-17,2,Thu,8:20PM,Cleveland Browns,,Cincinnati Bengals,35,30,434,1,353,1,0,5,81,0,True,False
2020-09-20,2,Sun,1:00PM,Tennessee Titans,,Jacksonville Jaguars,33,30,354,0,480,2,0,3,-126,-2,True,False
2020-09-20,2,Sun,4:25PM,Kansas City Chiefs,@,Los Angeles Chargers,23,20,414,0,479,1,0,3,-65,-1,False,True
2020-09-20,2,Sun,4:25PM,Baltimore Ravens,@,Houston Texans,33,16,407,0,304,2,0,17,103,-2,False,True
2020-09-20,2,Sun,4:05PM,Arizona Cardinals,,Washington Commanders,30,15,438,1,316,2,0,15,122,-1,True,False
2020-09-20,2,Sun,1:00PM,Los Angeles Rams,@,Philadelphia Eagles,37,19,449,1,363,3,0,18,86,-2,False,True
2020-09-20,2,Sun,1:00PM,San Francisco 49ers,@,New York Jets,31,13,359,1,277,0,0,18,82,1,False,True
2020-09-20,2,Sun,1:00PM,Green Bay Packers,,Detroit Lions,42,21,488,0,307,1,0,21,181,-1,True,False
2020-09-20,2,Sun,1:00PM,Pittsburgh Steelers,,Denver Broncos,26,21,410,2,319,2,0,5,91,0,True,False
2020-09-20,2,Sun,1:00PM,Indianapolis Colts,,Minnesota Vikings,28,11,354,1,175,3,0,17,179,-2,True,False
2020-09-20,2,Sun,1:00PM,Chicago Bears,,New York Giants,17,13,304,2,295,2,0,4,9,0,True,False
2020-09-20,2,Sun,1:00PM,Tampa Bay Buccaneers,,Carolina Panthers,31,17,339,2,427,4,0,14,-88,-2,True,False
2020-09-20,2,Sun,1:00PM,Buffalo Bills,@,Miami Dolphins,31,28,523,1,410,0,0,3,113,1,False,True
2020-09-20,2,Sun,1:00PM,Dallas Cowboys,,Atlanta Falcons,40,39,570,3,380,0,0,1,190,3,True,False
2020-09-20,2,Sun,8:20PM,Seattle Seahawks,,New England Patriots,35,30,429,1,464,1,0,5,-35,0,True,False
2020-09-21,2,Mon,8:15PM,Las Vegas Raiders,,New Orleans Saints,34,24,377,1,424,1,0,10,-47,0,True,False
2020-09-24,3,Thu,8:20PM,Miami Dolphins,@,Jacksonville Jaguars,31,13,294,0,318,2,0,18,-24,-2,False,True
2020-09-27,3,Sun,4:05PM,Carolina Panthers,@,Los Angeles Chargers,21,16,302,0,436,4,0,5,-134,-4,False,True
2020-09-27,3,Sun,1:00PM,Buffalo Bills,,Los Angeles Rams,35,32,375,2,478,2,0,3,-103,0,True,False
2020-09-27,3,Sun,1:00PM,Philadelphia Eagles,,Cincinnati Bengals,23,23,378,2,304,0,1,0,74,2,True,False
2020-09-27,3,Sun,1:00PM,Cleveland Browns,,Washington Commanders,34,20,300,0,309,5,0,14,-9,-5,True,False
2020-09-27,3,Sun,1:00PM,Pittsburgh Steelers,,Houston Texans,28,21,387,0,260,1,0,7,127,-1,True,False
2020-09-27,3,Sun,1:00PM,Chicago Bears,@,Atlanta Falcons,30,26,437,2,371,1,0,4,66,1,False,True
2020-09-27,3,Sun,1:00PM,Tennessee Titans,@,Minnesota Vikings,31,30,444,1,464,3,0,1,-20,-2,False,True
2020-09-27,3,Sun,1:00PM,New England Patriots,,Las Vegas Raiders,36,20,406,1,375,3,0,16,31,-2,True,False
2020-09-27,3,Sun,1:00PM,San Francisco 49ers,@,New York Giants,36,9,420,0,231,3,0,27,189,-3,False,True
2020-09-27,3,Sun,8:20PM,Green Bay Packers,@,New Orleans Saints,37,30,369,0,397,1,0,7,-28,-1,False,True
2020-09-27,3,Sun,4:05PM,Indianapolis Colts,,New York Jets,36,7,353,0,260,3,0,29,93,-3,True,False
2020-09-27,3,Sun,4:25PM,Detroit Lions,@,Arizona Cardinals,26,23,322,0,377,3,0,3,-55,-3,False,True
2020-09-27,3,Sun,4:25PM,Seattle Seahawks,,Dallas Cowboys,38,31,412,1,522,3,0,7,-110,-2,True,False
2020-09-27,3,Sun,4:25PM,Tampa Bay Buccaneers,@,Denver Broncos,28,10,353,0,226,2,0,18,127,-2,False,True
2020-09-28,3,Mon,8:15PM,Kansas City Chiefs,@,Baltimore Ravens,34,20,517,1,228,1,0,14,289,0,False,True
2020-10-01,4,Thu,8:20PM,Denver Broncos,@,New York Jets,37,28,359,3,321,0,0,9,38,3,False,True
2020-10-04,4,Sun,1:00PM,Carolina Panthers,,Arizona Cardinals,31,21,444,1,262,1,0,10,182,0,True,False
2020-10-04,4,Sun,1:00PM,Cincinnati Bengals,,Jacksonville Jaguars,33,25,505,1,429,1,0,8,76,0,True,False
2020-10-04,4,Sun,1:00PM,Cleveland Browns,@,Dallas Cowboys,49,38,508,0,566,3,0,11,-58,-3,False,True
2020-10-04,4,Sun,1:00PM,New Orleans Saints,@,Detroit Lions,35,29,392,1,281,1,0,6,111,0,False,True
2020-10-04,4,Sun,1:00PM,Minnesota Vikings,@,Houston Texans,31,23,410,0,386,1,0,8,24,-1,False,True
2020-10-04,4,Sun,1:00PM,Seattle Seahawks,@,Miami Dolphins,31,23,441,1,415,2,0,8,26,-1,False,True
2020-10-04,4,Sun,1:00PM,Baltimore Ravens,@,Washington Commanders,31,17,350,2,343,1,0,14,7,1,False,True
2020-10-04,4,Sun,1:00PM,Tampa Bay Buccaneers,,Los Angeles Chargers,38,31,484,1,324,2,0,7,160,-1,True,False
2020-10-04,4,Sun,4:05PM,Los Angeles Rams,,New York Giants,17,9,240,1,295,1,0,8,-55,0,True,False
2020-10-04,4,Sun,4:25PM,Buffalo Bills,@,Las Vegas Raiders,30,23,337,0,383,2,0,7,-46,-2,False,True
2020-10-04,4,Sun,8:20PM,Philadelphia Eagles,@,San Francisco 49ers,25,20,267,1,417,3,0,5,-150,-2,False,True
2020-10-04,4,Sun,1:00PM,Indianapolis Colts,@,Chicago Bears,19,11,289,0,269,1,0,8,20,-1,False,True
2020-10-05,4,Mon,8:15PM,Green Bay Packers,,Atlanta Falcons,30,16,403,0,327,0,0,14,76,0,True,False
2020-10-05,4,Mon,7:05PM,Kansas City Chiefs,,New England Patriots,26,10,323,1,357,4,0,16,-34,-3,True,False
2020-10-08,5,Thu,8:20PM,Chicago Bears,,Tampa Bay Buccaneers,20,19,243,1,339,1,0,1,-96,0,True,False
2020-10-11,5,Sun,1:00PM,Baltimore Ravens,,Cincinnati Bengals,27,3,332,1,205,3,0,24,127,-2,True,False
2020-10-11,5,Sun,8:20PM,Seattle Seahawks,,Minnesota Vikings,27,26,314,1,449,2,0,1,-135,-1,True,False
2020-10-11,5,Sun,4:25PM,Dallas Cowboys,,New York Giants,37,34,402,2,300,1,0,3,102,1,True,False
2020-10-11,5,Sun,4:25PM,Cleveland Browns,,Indianapolis Colts,32,23,385,2,308,2,0,9,77,0,True,False
2020-10-11,5,Sun,4:05PM,Miami Dolphins,@,San Francisco 49ers,43,17,436,0,259,3,0,26,177,-3,False,True
2020-10-11,5,Sun,1:00PM,Carolina Panthers,@,Atlanta Falcons,23,16,437,0,373,1,0,7,64,-1,False,True
2020-10-11,5,Sun,1:00PM,Pittsburgh Steelers,,Philadelphia Eagles,38,29,367,1,336,2,0,9,31,-1,True,False
2020-10-11,5,Sun,1:00PM,Las Vegas Raiders,@,Kansas City Chiefs,40,32,490,1,413,1,0,8,77,0,False,True
2020-10-11,5,Sun,1:00PM,Houston Texans,,Jacksonville Jaguars,30,14,486,2,364,2,0,16,122,0,True,False
2020-10-11,5,Sun,1:00PM,Arizona Cardinals,@,New York Jets,30,10,496,1,285,0,0,20,211,1,False,True
2020-10-11,5,Sun,1:00PM,Los Angeles Rams,@,Washington Commanders,30,10,429,1,108,0,0,20,321,1,False,True
2020-10-12,5,Mon,8:15PM,New Orleans Saints,,Los Angeles Chargers,30,27,408,1,350,0,0,3,58,1,True,False
2020-10-13,5,Tue,7:00PM,Tennessee Titans,,Buffalo Bills,42,16,334,0,370,3,0,26,-36,-3,True,False
2020-10-18,6,Sun,8:20PM,San Francisco 49ers,,Los Angeles Rams,24,16,390,0,311,1,0,8,79,-1,True,False
2020-10-18,6,Sun,4:25PM,Tampa Bay Buccaneers,,Green Bay Packers,38,10,324,0,201,2,0,28,123,-2,True,False
2020-10-18,6,Sun,4:05PM,Miami Dolphins,,New York Jets,24,0,302,2,263,1,0,24,39,1,True,False
2020-10-18,6,Sun,1:00PM,Baltimore Ravens,@,Philadelphia Eagles,30,28,355,0,364,1,0,2,-9,-1,False,True
2020-10-18,6,Sun,1:00PM,New York Giants,,Washington Commanders,20,19,240,1,337,2,0,1,-97,-1,True,False
2020-10-18,6,Sun,1:00PM,Indianapolis Colts,,Cincinnati Bengals,31,27,430,2,398,1,0,4,32,1,True,False
2020-10-18,6,Sun,1:00PM,Pittsburgh Steelers,,Cleveland Browns,38,7,277,0,220,2,0,31,57,-2,True,False
2020-10-18,6,Sun,1:00PM,Chicago Bears,@,Carolina Panthers,23,16,261,1,303,3,0,7,-42,-2,False,True
2020-10-18,6,Sun,1:00PM,Atlanta Falcons,@,Minnesota Vikings,40,23,462,1,365,3,0,17,97,-2,False,True
2020-10-18,6,Sun,1:00PM,Denver Broncos,@,New England Patriots,18,12,299,2,288,3,0,6,11,-1,False,True
2020-10-18,6,Sun,1:00PM,Tennessee Titans,,Houston Texans,42,36,607,2,412,0,0,6,195,2,True,False
2020-10-18,6,Sun,1:00PM,Detroit Lions,@,Jacksonville Jaguars,34,16,403,1,275,2,0,18,128,-1,False,True
2020-10-19,6,Mon,8:15PM,Arizona Cardinals,@,Dallas Cowboys,38,10,438,0,344,4,0,28,94,-4,False,True
2020-10-19,6,Mon,5:00PM,Kansas City Chiefs,@,Buffalo Bills,26,17,466,1,206,1,0,9,260,0,False,True
2020-10-22,7,Thu,8:20PM,Philadelphia Eagles,,New York Giants,22,21,442,1,325,3,0,1,117,-2,True,False
2020-10-25,7,Sun,1:00PM,Pittsburgh Steelers,@,Tennessee Titans,27,24,362,3,292,0,0,3,70,3,False,True
2020-10-25,7,Sun,1:00PM,Detroit Lions,@,Atlanta Falcons,23,22,386,0,388,1,0,1,-2,-1,False,True
2020-10-25,7,Sun,1:00PM,Buffalo Bills,@,New York Jets,18,10,422,1,191,2,0,8,231,-1,False,True
2020-10-25,7,Sun,1:00PM,New Orleans Saints,,Carolina Panthers,27,24,415,1,283,0,0,3,132,1,True,False
2020-10-25,7,Sun,1:00PM,Cleveland Browns,@,Cincinnati Bengals,37,34,398,1,468,2,0,3,-70,-1,False,True
2020-10-25,7,Sun,1:00PM,Washington Commanders,,Dallas Cowboys,25,3,397,0,142,1,0,22,255,-1,True,False
2020-10-25,7,Sun,4:05PM,Tampa Bay Buccaneers,@,Las Vegas Raiders,45,20,454,0,347,1,0,25,107,-1,False,True
2020-10-25,7,Sun,4:25PM,Kansas City Chiefs,@,Denver Broncos,43,16,286,1,411,4,0,27,-125,-3,False,True
2020-10-25,7,Sun,4:25PM,San Francisco 49ers,@,New England Patriots,33,6,467,2,241,4,0,27,226,-2,False,True
2020-10-25,7,Sun,4:25PM,Los Angeles Chargers,,Jacksonville Jaguars,39,29,484,0,294,1,0,10,190,-1,True,False
2020-10-25,7,Sun,8:20PM,Arizona Cardinals,,Seattle Seahawks,37,34,519,2,572,3,0,3,-53,-1,True,False
2020-10-25,7,Sun,1:00PM,Green Bay Packers,@,Houston Texans,35,20,379,0,365,1,0,15,14,-1,False,True
2020-10-26,7,Mon,8:15PM,Los Angeles Rams,,Chicago Bears,24,10,371,1,279,2,0,14,92,-1,True,False
2020-10-29,8,Thu,8:20PM,Atlanta Falcons,@,Carolina Panthers,25,17,401,1,304,1,0,8,97,0,False,True
2020-11-01,8,Sun,1:00PM,Miami Dolphins,,Los Angeles Rams,28,17,145,2,471,4,0,11,-326,-2,True,False
2020-11-01,8,Sun,1:00PM,Pittsburgh Steelers,@,Baltimore Ravens,28,24,221,1,457,4,0,4,-236,-3,False,True
2020-11-01,8,Sun,1:00PM,Cincinnati Bengals,,Tennessee Titans,31,20,367,0,441,1,0,11,-74,-1,True,False
2020-11-01,8,Sun,1:00PM,Las Vegas Raiders,@,Cleveland Browns,16,6,309,0,223,1,0,10,86,-1,False,True
2020-11-01,8,Sun,1:00PM,Kansas City Chiefs,,New York Jets,35,9,496,0,221,1,0,26,275,-1,True,False
2020-11-01,8,Sun,4:05PM,Denver Broncos,,Los Angeles Chargers,31,30,351,1,485,2,0,1,-134,-1,True,False
2020-11-01,8,Sun,4:25PM,Seattle Seahawks,,San Francisco 49ers,37,27,350,0,351,2,0,10,-1,-2,True,False
2020-11-01,8,Sun,4:25PM,New Orleans Saints,@,Chicago Bears,26,23,394,0,329,1,0,3,65,-1,False,True
2020-11-01,8,Sun,8:20PM,Philadelphia Eagles,,Dallas Cowboys,23,9,222,4,265,2,0,14,-43,2,True,False
2020-11-01,8,Sun,1:00PM,Indianapolis Colts,@,Detroit Lions,41,21,366,0,326,2,0,20,40,-2,False,True
2020-11-01,8,Sun,1:00PM,Buffalo Bills,,New England Patriots,24,21,339,1,349,1,0,3,-10,0,True,False
2020-11-01,8,Sun,1:00PM,Minnesota Vikings,@,Green Bay Packers,28,22,324,0,400,1,0,6,-76,-1,False,True
2020-11-02,8,Mon,8:15PM,Tampa Bay Buccaneers,@,New York Giants,25,23,344,1,357,2,0,2,-13,-1,False,True
2020-11-05,9,Thu,8:20PM,Green Bay Packers,@,San Francisco 49ers,34,17,405,0,337,2,0,17,68,-2,False,True
2020-11-08,9,Sun,8:20PM,New Orleans Saints,@,Tampa Bay Buccaneers,38,3,420,2,194,3,0,35,226,-1,False,True
2020-11-08,9,Sun,4:25PM,Pittsburgh Steelers,@,Dallas Cowboys,24,19,355,0,364,2,0,5,-9,-2,False,True
2020-11-08,9,Sun,4:25PM,Miami Dolphins,@,Arizona Cardinals,34,31,312,0,442,1,0,3,-130,-1,False,True
2020-11-08,9,Sun,4:05PM,Las Vegas Raiders,@,Los Angeles Chargers,31,26,320,1,440,1,0,5,-120,0,False,True
2020-11-08,9,Sun,1:00PM,New York Giants,@,Washington Commanders,23,20,350,0,402,5,0,3,-52,-5,False,True
2020-11-08,9,Sun,1:00PM,Tennessee Titans,,Chicago Bears,24,17,228,0,375,2,0,7,-147,-2,True,False
2020-11-08,9,Sun,1:00PM,Kansas City Chiefs,,Carolina Panthers,33,31,397,1,435,0,0,2,-38,1,True,False
2020-11-08,9,Sun,1:00PM,Buffalo Bills,,Seattle Seahawks,44,34,420,0,419,4,0,10,1,-4,True,False
2020-11-08,9,Sun,1:00PM,Atlanta Falcons,,Denver Broncos,34,27,363,1,405,1,0,7,-42,0,True,False
2020-11-08,9,Sun,1:00PM,Houston Texans,@,Jacksonville Jaguars,27,25,374,1,403,1,0,2,-29,0,False,True
2020-11-08,9,Sun,1:00PM,Minnesota Vikings,,Detroit Lions,34,20,487,0,421,3,0,14,66,-3,True,False
2020-11-08,9,Sun,1:00PM,Baltimore Ravens,@,Indianapolis Colts,24,10,266,1,339,2,0,14,-73,-1,False,True
2020-11-09,9,Mon,8:15PM,New England Patriots,@,New York Jets,30,27,433,0,322,1,0,3,111,-1,False,True
2020-11-12,10,Thu,8:20PM,Indianapolis Colts,@,Tennessee Titans,34,17,430,0,294,0,0,17,136,0,False,True
2020-11-15,10,Sun,1:00PM,Cleveland Browns,,Houston Texans,10,7,356,0,243,0,0,3,113,0,True,False
2020-11-15,10,Sun,4:05PM,Arizona Cardinals,,Buffalo Bills,32,30,453,2,369,2,0,2,84,0,True,False
2020-11-15,10,Sun,1:00PM,Green Bay Packers,,Jacksonville Jaguars,24,20,395,2,260,1,0,4,135,1,True,False
2020-11-15,10,Sun,1:00PM,Tampa Bay Buccaneers,@,Carolina Panthers,46,23,544,1,187,1,0,23,357,0,False,True
2020-11-15,10,Sun,1:00PM,Detroit Lions,,Washington Commanders,30,27,372,0,464,1,0,3,-92,-1,True,False
2020-11-15,10,Sun,1:00PM,New York Giants,,Philadelphia Eagles,27,17,382,0,346,0,0,10,36,0,True,False
2020-11-15,10,Sun,4:05PM,Las Vegas Raiders,,Denver Broncos,37,12,357,0,313,5,0,25,44,-5,True,False
2020-11-15,10,Sun,4:05PM,Miami Dolphins,,Los Angeles Chargers,29,21,280,1,273,1,0,8,7,0,True,False
2020-11-15,10,Sun,8:20PM,New England Patriots,,Baltimore Ravens,23,17,308,0,357,1,0,6,-49,-1,True,False
2020-11-15,10,Sun,4:25PM,Pittsburgh Steelers,,Cincinnati Bengals,36,10,377,0,324,2,0,26,53,-2,True,False
2020-11-15,10,Sun,4:25PM,New Orleans Saints,,San Francisco 49ers,27,13,237,2,281,4,0,14,-44,-2,True,False
2020-11-15,10,Sun,4:25PM,Los Angeles Rams,,Seattle Seahawks,23,16,389,1,333,3,0,7,56,-2,True,False
2020-11-16,10,Mon,8:15PM,Minnesota Vikings,@,Chicago Bears,19,13,385,2,149,2,0,6,236,0,False,True
2020-11-19,11,Thu,8:20PM,Seattle Seahawks,,Arizona Cardinals,28,21,347,0,314,0,0,7,33,0,True,False
2020-11-22,11,Sun,8:20PM,Kansas City Chiefs,@,Las Vegas Raiders,35,31,460,1,364,1,0,4,96,0,False,True
2020-11-22,11,Sun,1:00PM,New Orleans Saints,,Atlanta Falcons,24,9,376,1,248,2,0,15,128,-1,True,False
2020-11-22,11,Sun,1:00PM,Washington Commanders,,Cincinnati Bengals,20,9,325,1,272,2,0,11,53,-1,True,False
2020-11-22,11,Sun,1:00PM,Cleveland Browns,,Philadelphia Eagles,22,17,324,1,315,3,0,5,9,-2,True,False
2020-11-22,11,Sun,1:00PM,Carolina Panthers,,Detroit Lions,20,0,374,2,185,1,0,20,189,1,True,False
2020-11-22,11,Sun,4:05PM,Denver Broncos,,Miami Dolphins,20,13,459,2,223,1,0,7,236,1,True,False
2020-11-22,11,Sun,4:05PM,Los Angeles Chargers,,New York Jets,34,28,376,1,292,1,0,6,84,0,True,False
2020-11-22,11,Sun,4:25PM,Indianapolis Colts,,Green Bay Packers,34,31,420,2,367,4,0,3,53,-2,True,False
2020-11-22,11,Sun,4:25PM,Dallas Cowboys,@,Minnesota Vikings,31,28,376,1,430,2,0,3,-54,-1,False,True
2020-11-22,11,Sun,1:00PM,Tennessee Titans,@,Baltimore Ravens,30,24,423,1,306,1,0,6,117,0,False,True
2020-11-22,11,Sun,1:00PM,Houston Texans,,New England Patriots,27,20,399,0,435,0,0,7,-36,0,True,False
2020-11-22,11,Sun,1:00PM,Pittsburgh Steelers,@,Jacksonville Jaguars,27,3,373,1,206,4,0,24,167,-3,False,True
2020-11-23,11,Mon,8:15PM,Los Angeles Rams,@,Tampa Bay Buccaneers,27,24,413,2,251,2,0,3,162,0,False,True
2020-11-26,12,Thu,4:30PM,Washington Commanders,@,Dallas Cowboys,41,16,338,1,247,2,0,25,91,-1,False,True
2020-11-26,12,Thu,12:30PM,Houston Texans,@,Detroit Lions,41,25,384,1,388,3,0,16,-4,-2,False,True
2020-11-29,12,Sun,1:00PM,Buffalo Bills,,Los Angeles Chargers,27,17,332,3,367,1,0,10,-35,2,True,False
2020-11-29,12,Sun,1:00PM,New York Giants,@,Cincinnati Bengals,19,17,386,1,155,3,0,2,231,-2,False,True
2020-11-29,12,Sun,8:20PM,Green Bay Packers,,Chicago Bears,41,25,393,0,350,3,0,16,43,-3,True,False
2020-11-29,12,Sun,4:25PM,Kansas City Chiefs,@,Tampa Bay Buccaneers,27,24,543,1,417,2,0,3,126,-1,False,True
2020-11-29,12,Sun,4:05PM,San Francisco 49ers,@,Los Angeles Rams,23,20,345,3,308,4,0,3,37,-1,False,True
2020-11-29,12,Sun,4:05PM,New Orleans Saints,@,Denver Broncos,31,3,292,1,112,3,0,28,180,-2,False,True
2020-11-29,12,Sun,1:00PM,Atlanta Falcons,,Las Vegas Raiders,43,6,304,1,243,5,0,37,61,-4,True,False
2020-11-29,12,Sun,1:00PM,Miami Dolphins,@,New York Jets,20,3,345,2,260,2,0,17,85,0,False,True
2020-11-29,12,Sun,1:00PM,New England Patriots,,Arizona Cardinals,20,17,179,2,298,1,0,3,-119,1,True,False
2020-11-29,12,Sun,1:00PM,Tennessee Titans,@,Indianapolis Colts,45,26,449,0,336,1,0,19,113,-1,False,True
2020-11-29,12,Sun,1:00PM,Minnesota Vikings,,Carolina Panthers,28,27,387,3,374,1,0,1,13,2,True,False
2020-11-29,12,Sun,1:00PM,Cleveland Browns,@,Jacksonville Jaguars,27,25,459,1,375,0,0,2,84,1,False,True
2020-11-30,12,Mon,8:15PM,Seattle Seahawks,@,Philadelphia Eagles,23,17,301,0,250,1,0,6,51,-1,False,True
2020-12-02,12,Wed,3:40PM,Pittsburgh Steelers,,Baltimore Ravens,19,14,334,2,219,2,0,5,115,0,True,False
2020-12-06,13,Sun,8:20PM,Kansas City Chiefs,,Denver Broncos,22,16,447,0,330,2,0,6,117,-2,True,False
2020-12-06,13,Sun,4:25PM,New England Patriots,@,Los Angeles Chargers,45,0,291,0,258,2,0,45,33,-2,False,True
2020-12-06,13,Sun,4:25PM,Green Bay Packers,,Philadelphia Eagles,30,16,437,0,278,1,0,14,159,-1,True,False
2020-12-06,13,Sun,4:05PM,New York Giants,@,Seattle Seahawks,17,12,290,1,327,2,0,5,-37,-1,False,True
2020-12-06,13,Sun,4:05PM,Los Angeles Rams,@,Arizona Cardinals,38,28,463,1,232,2,0,10,231,-1,False,True
2020-12-06,13,Sun,1:00PM,Minnesota Vikings,,Jacksonville Jaguars,27,24,420,2,390,4,0,3,30,-2,True,False
2020-12-06,13,Sun,1:00PM,Indianapolis Colts,@,Houston Texans,26,20,371,0,398,2,0,6,-27,-2,False,True
2020-12-06,13,Sun,1:00PM,Cleveland Browns,@,Tennessee Titans,41,35,458,1,431,3,0,6,27,-2,False,True
2020-12-06,13,Sun,1:00PM,Miami Dolphins,,Cincinnati Bengals,19,7,406,1,196,2,0,12,210,-1,True,False
2020-12-06,13,Sun,1:00PM,Detroit Lions,@,Chicago Bears,34,30,460,1,389,1,0,4,71,0,False,True
2020-12-06,13,Sun,1:00PM,New Orleans Saints,@,Atlanta Falcons,21,16,424,1,332,1,0,5,92,0,False,True
2020-12-06,13,Sun,1:00PM,Las Vegas Raiders,@,New York Jets,31,28,440,2,376,3,0,3,64,-1,False,True
2020-12-07,13,Mon,5:00PM,Washington Commanders,@,Pittsburgh Steelers,23,17,318,0,326,1,0,6,-8,-1,False,True
2020-12-07,13,Mon,8:15PM,Buffalo Bills,@,San Francisco 49ers,34,24,449,1,402,2,0,10,47,-1,False,True
2020-12-08,13,Tue,8:05PM,Baltimore Ravens,,Dallas Cowboys,34,17,401,1,388,1,0,17,13,0,True,False
2020-12-10,14,Thu,8:20PM,Los Angeles Rams,,New England Patriots,24,3,318,1,220,1,0,21,98,0,True,False
2020-12-13,14,Sun,1:00PM,Denver Broncos,@,Carolina Panthers,32,27,365,1,370,0,0,5,-5,1,False,True
2020-12-13,14,Sun,1:00PM,Chicago Bears,,Houston Texans,36,7,410,0,263,2,0,29,147,-2,True,False
2020-12-13,14,Sun,1:00PM,Arizona Cardinals,@,New York Giants,26,7,390,0,159,3,0,19,231,-3,False,True
2020-12-13,14,Sun,1:00PM,Tennessee Titans,@,Jacksonville Jaguars,31,10,454,1,354,1,0,21,100,0,False,True
2020-12-13,14,Sun,1:00PM,Kansas City Chiefs,@,Miami Dolphins,33,27,448,4,367,1,0,6,81,3,False,True
2020-12-13,14,Sun,1:00PM,Tampa Bay Buccaneers,,Minnesota Vikings,26,14,303,0,335,1,0,12,-32,-1,True,False
2020-12-13,14,Sun,4:05PM,Seattle Seahawks,,New York Jets,40,3,410,1,185,1,0,37,225,0,True,False
2020-12-13,14,Sun,4:25PM,Los Angeles Chargers,,Atlanta Falcons,20,17,345,1,319,3,0,3,26,-2,True,False
2020-12-13,14,Sun,4:25PM,Green Bay Packers,@,Detroit Lions,31,24,410,0,293,0,0,7,117,0,False,True
2020-12-13,14,Sun,4:25PM,Philadelphia Eagles,,New Orleans Saints,24,21,413,1,358,2,0,3,55,-1,True,False
2020-12-13,14,Sun,4:25PM,Washington Commanders,@,San Francisco 49ers,23,15,193,1,344,3,0,8,-151,-2,False,True
2020-12-13,14,Sun,8:20PM,Buffalo Bills,,Pittsburgh Steelers,26,15,334,2,224,2,0,11,110,0,True,False
2020-12-13,14,Sun,1:00PM,Dallas Cowboys,@,Cincinnati Bengals,30,7,272,0,309,3,0,23,-37,-3,False,True
2020-12-13,14,Sun,4:05PM,Indianapolis Colts,@,Las Vegas Raiders,44,27,456,0,424,3,0,17,32,-3,False,True
2020-12-14,14,Mon,8:15PM,Baltimore Ravens,@,Cleveland Browns,47,42,385,0,493,1,0,5,-108,-1,False,True
2020-12-17,15,Thu,8:20PM,Los Angeles Chargers,@,Las Vegas Raiders,30,27,402,0,449,1,0,3,-47,-1,False,True
2020-12-19,15,Sat,8:15PM,Green Bay Packers,,Carolina Panthers,24,16,291,0,364,1,0,8,-73,-1,True,False
2020-12-19,15,Sat,4:30PM,Buffalo Bills,@,Denver Broncos,48,19,534,1,255,1,0,29,279,0,False,True
2020-12-20,15,Sun,4:05PM,New York Jets,@,Los Angeles Rams,23,20,289,0,303,1,0,3,-14,-1,False,True
2020-12-20,15,Sun,1:00PM,Baltimore Ravens,,Jacksonville Jaguars,40,14,409,1,267,1,0,26,142,0,True,False
2020-12-20,15,Sun,1:00PM,Tennessee Titans,,Detroit Lions,46,25,463,0,430,3,0,21,33,-3,True,False
2020-12-20,15,Sun,1:00PM,Dallas Cowboys,,San Francisco 49ers,41,33,291,0,458,4,0,8,-167,-4,True,False
2020-12-20,15,Sun,1:00PM,Indianapolis Colts,,Houston Texans,27,20,350,0,425,2,0,7,-75,-2,True,False
2020-12-20,15,Sun,1:00PM,Chicago Bears,@,Minnesota Vikings,33,27,397,1,407,1,0,6,-10,0,False,True
2020-12-20,15,Sun,1:00PM,Tampa Bay Buccaneers,@,Atlanta Falcons,31,27,416,0,369,0,0,4,47,0,False,True
2020-12-20,15,Sun,4:05PM,Arizona Cardinals,,Philadelphia Eagles,33,26,526,3,422,0,0,7,104,3,True,False
2020-12-20,15,Sun,1:00PM,Miami Dolphins,,New England Patriots,22,12,383,1,303,1,0,10,80,0,True,False
2020-12-20,15,Sun,1:00PM,Seattle Seahawks,@,Washington Commanders,20,15,302,1,353,2,0,5,-51,-1,False,True
2020-12-20,15,Sun,4:25PM,Kansas City Chiefs,@,New Orleans Saints,32,29,411,1,285,1,0,3,126,0,False,True
2020-12-20,15,Sun,8:20PM,Cleveland Browns,@,New York Giants,20,6,392,0,288,0,0,14,104,0,False,True
2020-12-21,15,Mon,8:15PM,Cincinnati Bengals,,Pittsburgh Steelers,27,17,230,0,244,3,0,10,-14,-3,True,False
2020-12-25,16,Fri,4:30PM,New Orleans Saints,,Minnesota Vikings,52,33,583,2,364,0,0,19,219,2,True,False
2020-12-26,16,Sat,8:15PM,Miami Dolphins,@,Las Vegas Raiders,26,25,383,0,418,1,0,1,-35,-1,False,True
2020-12-26,16,Sat,1:00PM,Tampa Bay Buccaneers,@,Detroit Lions,47,7,588,0,186,2,0,40,402,-2,False,True
2020-12-26,16,Sat,4:30PM,San Francisco 49ers,@,Arizona Cardinals,20,12,398,1,350,2,0,8,48,-1,False,True
2020-12-27,16,Sun,1:00PM,Baltimore Ravens,,New York Giants,27,13,432,1,269,0,0,14,163,1,True,False
2020-12-27,16,Sun,1:00PM,New York Jets,,Cleveland Browns,23,16,333,0,299,2,0,7,34,-2,True,False
2020-12-27,16,Sun,1:00PM,Cincinnati Bengals,@,Houston Texans,37,31,540,0,488,1,0,6,52,-1,False,True
2020-12-27,16,Sun,1:00PM,Chicago Bears,@,Jacksonville Jaguars,41,17,391,1,279,2,0,24,112,-1,False,True
2020-12-27,16,Sun,1:00PM,Kansas City Chiefs,,Atlanta Falcons,17,14,395,2,367,1,0,3,28,1,True,False
2020-12-27,16,Sun,4:05PM,Carolina Panthers,@,Washington Commanders,20,13,280,2,386,4,0,7,-106,-2,False,True
2020-12-27,16,Sun,8:20PM,Green Bay Packers,,Tennessee Titans,40,14,448,1,260,2,0,26,188,-1,True,False
2020-12-27,16,Sun,4:25PM,Seattle Seahawks,,Los Angeles Rams,20,9,292,0,334,1,0,11,-42,-1,True,False
2020-12-27,16,Sun,4:25PM,Dallas Cowboys,,Philadelphia Eagles,37,17,513,1,477,3,0,20,36,-2,True,False
2020-12-27,16,Sun,4:05PM,Los Angeles Chargers,,Denver Broncos,19,16,316,0,396,2,0,3,-80,-2,True,False
2020-12-27,16,Sun,1:00PM,Pittsburgh Steelers,,Indianapolis Colts,28,24,354,0,365,2,0,4,-11,-2,True,False
2020-12-28,16,Mon,8:15PM,Buffalo Bills,@,New England Patriots,38,9,474,0,201,0,0,29,273,0,False,True
2021-01-03,17,Sun,8:20PM,Washington Commanders,@,Philadelphia Eagles,20,14,248,2,216,3,0,6,32,-1,False,True
2021-01-03,17,Sun,4:25PM,Tennessee Titans,@,Houston Texans,41,38,492,1,457,1,0,3,35,0,False,True
2021-01-03,17,Sun,4:25PM,Los Angeles Chargers,@,Kansas City Chiefs,38,21,416,0,268,1,0,17,148,-1,False,True
2021-01-03,17,Sun,4:25PM,Seattle Seahawks,@,San Francisco 49ers,26,23,280,0,328,1,0,3,-48,-1,False,True
2021-01-03,17,Sun,4:25PM,New Orleans Saints,@,Carolina Panthers,33,7,347,0,320,5,0,26,27,-5,False,True
2021-01-03,17,Sun,1:00PM,New England Patriots,,New York Jets,28,14,404,0,350,2,0,14,54,-2,True,False
2021-01-03,17,Sun,4:25PM,Los Angeles Rams,,Arizona Cardinals,18,7,333,2,214,1,0,11,119,1,True,False
2021-01-03,17,Sun,1:00PM,Minnesota Vikings,@,Detroit Lions,37,35,508,0,417,2,0,2,91,-2,False,True
2021-01-03,17,Sun,1:00PM,New York Giants,,Dallas Cowboys,23,19,336,2,307,1,0,4,29,1,True,False
2021-01-03,17,Sun,4:25PM,Green Bay Packers,@,Chicago Bears,35,16,316,1,356,2,0,19,-40,-1,False,True
2021-01-03,17,Sun,1:00PM,Cleveland Browns,,Pittsburgh Steelers,24,22,358,0,394,1,0,2,-36,-1,True,False
2021-01-03,17,Sun,1:00PM,Buffalo Bills,,Miami Dolphins,56,26,455,2,454,4,0,30,1,-2,True,False
2021-01-03,17,Sun,1:00PM,Tampa Bay Buccaneers,,Atlanta Falcons,44,27,485,1,385,2,0,17,100,-1,True,False
2021-01-03,17,Sun,4:25PM,Las Vegas Raiders,@,Denver Broncos,32,31,465,4,446,0,0,1,19,4,False,True
2021-01-03,17,Sun,1:00PM,Baltimore Ravens,@,Cincinnati Bengals,38,3,525,1,195,2,0,35,330,-1,False,True
2021-01-03,17,Sun,4:25PM,Indianapolis Colts,,Jacksonville Jaguars,28,14,437,1,283,1,0,14,154,0,True,False
2021-01-09,WildCard,Sat,8:15PM,Tampa Bay Buccaneers,@,Washington Commanders,31,23,507,1,375,1,0,8,132,0,False,True
2021-01-09,WildCard,Sat,4:40PM,Los Angeles Rams,@,Seattle Seahawks,30,20,333,0,278,2,0,10,55,-2,False,True
2021-01-09,WildCard,Sat,1:05PM,Buffalo Bills,,Indianapolis Colts,27,24,397,0,472,0,0,3,-75,0,True,False
2021-01-10,WildCard,Sun,1:05PM,Baltimore Ravens,@,Tennessee Titans,20,13,401,1,209,1,0,7,192,0,False,True
2021-01-10,WildCard,Sun,8:15PM,Cleveland Browns,@,Pittsburgh Steelers,48,37,390,0,553,5,0,11,-163,-5,False,True
2021-01-10,WildCard,Sun,4:40PM,New Orleans Saints,,Chicago Bears,21,9,385,1,239,0,0,12,146,1,True,False
2021-01-16,Division,Sat,8:15PM,Buffalo Bills,,Baltimore Ravens,17,3,220,0,340,1,0,14,-120,-1,True,False
2021-01-16,Division,Sat,4:35PM,Green Bay Packers,,Los Angeles Rams,32,18,484,0,244,0,0,14,240,0,True,False
2021-01-17,Division,Sun,6:40PM,Tampa Bay Buccaneers,@,New Orleans Saints,30,20,316,0,294,4,0,10,22,-4,False,True
2021-01-17,Division,Sun,3:05PM,Kansas City Chiefs,,Cleveland Browns,22,17,438,1,308,2,0,5,130,-1,True,False
2021-01-24,ConfChamp,Sun,6:40PM,Kansas City Chiefs,,Buffalo Bills,38,24,439,1,363,1,0,14,76,0,True,False
2021-01-24,ConfChamp,Sun,3:05PM,Tampa Bay Buccaneers,@,Green Bay Packers,31,26,351,3,381,2,0,5,-30,1,False,True
2021-02-07,SuperBowl,Sun,6:30PM,Tampa Bay Buccaneers,N,Kansas City Chiefs,31,9,340,0,350,2,0,22,-10,-2,False,False
2021-09-09,1,Thu,8:20PM,Tampa Bay Buccaneers,,Dallas Cowboys,31,29,431,4,451,1,0,2,-20,3,True,False
2021-09-12,1,Sun,1:00PM,Philadelphia Eagles,@,Atlanta Falcons,32,6,434,0,260,0,0,26,174,0,False,True
2021-09-12,1,Sun,1:00PM,Carolina Panthers,,New York Jets,19,14,381,1,252,1,0,5,129,0,True,False
2021-09-12,1,Sun,1:00PM,Pittsburgh Steelers,@,Buffalo Bills,23,16,252,0,371,1,0,7,-119,-1,False,True
2021-09-12,1,Sun,1:00PM,Seattle Seahawks,@,Indianapolis Colts,28,16,381,1,336,1,0,12,45,0,False,True
2021-09-12,1,Sun,1:00PM,Cincinnati Bengals,,Minnesota Vikings,27,24,366,0,403,1,0,3,-37,-1,True,False
2021-09-12,1,Sun,8:20PM,Los Angeles Rams,,Chicago Bears,34,14,386,0,322,2,0,20,64,-2,True,False
2021-09-12,1,Sun,4:25PM,New Orleans Saints,,Green Bay Packers,38,3,322,0,229,3,0,35,93,-3,True,False
2021-09-12,1,Sun,4:25PM,Denver Broncos,@,New York Giants,27,13,420,1,314,1,0,14,106,0,False,True
2021-09-12,1,Sun,4:25PM,Miami Dolphins,@,New England Patriots,17,16,259,1,393,2,0,1,-134,-1,False,True
2021-09-12,1,Sun,1:00PM,Los Angeles Chargers,@,Washington Commanders,20,16,424,2,259,1,0,4,165,1,False,True
2021-09-12,1,Sun,1:00PM,Houston Texans,,Jacksonville Jaguars,37,21,449,0,395,3,0,16,54,-3,True,False
2021-09-12,1,Sun,1:00PM,San Francisco 49ers,@,Detroit Lions,41,33,442,2,430,1,0,8,12,1,False,True
2021-09-12,1,Sun,1:00PM,Arizona Cardinals,@,Tennessee Titans,38,13,416,1,248,3,0,25,168,-2,False,True
2021-09-12,1,Sun,4:25PM,Kansas City Chiefs,,Cleveland Browns,33,29,397,0,457,2,0,4,-60,-2,True,False
2021-09-13,1,Mon,8:15PM,Las Vegas Raiders,,Baltimore Ravens,33,27,491,1,406,2,0,6,85,-1,True,False
2021-09-16,2,Thu,8:20PM,Washington Commanders,,New York Giants,30,29,407,1,391,0,0,1,16,1,True,False
2021-09-19,2,Sun,1:00PM,San Francisco 49ers,@,Philadelphia Eagles,17,11,306,0,328,0,0,6,-22,0,False,True
2021-09-19,2,Sun,4:05PM,Arizona Cardinals,,Minnesota Vikings,34,33,474,2,419,0,0,1,55,2,True,False
2021-09-19,2,Sun,4:05PM,Tampa Bay Buccaneers,,Atlanta Falcons,48,25,341,1,348,3,0,23,-7,-2,True,False
2021-09-19,2,Sun,1:00PM,New England Patriots,@,New York Jets,25,6,260,0,336,4,0,19,-76,-4,False,True
2021-09-19,2,Sun,1:00PM,Buffalo Bills,@,Miami Dolphins,35,0,314,2,216,3,0,35,98,-1,False,True
2021-09-19,2,Sun,1:00PM,Los Angeles Rams,@,Indianapolis Colts,27,24,371,2,354,2,0,3,17,0,False,True
2021-09-19,2,Sun,1:00PM,Cleveland Browns,,Houston Texans,31,21,355,2,302,2,0,10,53,0,True,False
2021-09-19,2,Sun,1:00PM,Chicago Bears,,Cincinnati Bengals,20,17,206,1,248,4,0,3,-42,-3,True,False
2021-09-19,2,Sun,1:00PM,Carolina Panthers,,New Orleans Saints,26,7,383,1,128,2,0,19,255,-1,True,False
2021-09-19,2,Sun,4:25PM,Dallas Cowboys,@,Los Angeles Chargers,20,17,419,1,408,2,0,3,11,-1,False,True
2021-09-19,2,Sun,1:00PM,Denver Broncos,@,Jacksonville Jaguars,23,13,398,0,189,2,0,10,209,-2,False,True
2021-09-19,2,Sun,4:25PM,Tennessee Titans,@,Seattle Seahawks,33,30,532,1,397,0,0,3,135,1,False,True
2021-09-19,2,Sun,1:00PM,Las Vegas Raiders,@,Pittsburgh Steelers,26,17,425,0,331,1,0,9,94,-1,False,True
2021-09-19,2,Sun,8:20PM,Baltimore Ravens,,Kansas City Chiefs,36,35,481,2,405,2,0,1,76,0,True,False
2021-09-20,2,Mon,8:15PM,Green Bay Packers,,Detroit Lions,35,17,323,0,344,2,0,18,-21,-2,True,False
2021-09-23,3,Thu,8:20PM,Carolina Panthers,@,Houston Texans,24,9,407,0,193,0,0,15,214,0,False,True
2021-09-26,3,Sun,1:00PM,Atlanta Falcons,@,New York Giants,17,14,296,1,346,1,0,3,-50,0,False,True
2021-09-26,3,Sun,1:00PM,Buffalo Bills,,Washington Commanders,43,21,481,0,290,3,0,22,191,-3,True,False
2021-09-26,3,Sun,1:00PM,Cleveland Browns,,Chicago Bears,26,6,418,0,47,0,0,20,371,0,True,False
2021-09-26,3,Sun,1:00PM,Cincinnati Bengals,@,Pittsburgh Steelers,24,10,268,1,342,2,0,14,-74,-1,False,True
2021-09-26,3,Sun,1:00PM,Tennessee Titans,,Indianapolis Colts,25,16,368,3,265,0,0,9,103,3,True,False
2021-09-26,3,Sun,1:00PM,Arizona Cardinals,@,Jacksonville Jaguars,31,19,407,1,361,4,0,12,46,-3,False,True
2021-09-26,3,Sun,8:20PM,Green Bay Packers,@,San Francisco 49ers,30,28,353,0,298,2,0,2,55,-2,False,True
2021-09-26,3,Sun,1:00PM,Los Angeles Chargers,@,Kansas City Chiefs,30,24,352,0,437,4,0,6,-85,-4,False,True
2021-09-26,3,Sun,1:00PM,New Orleans Saints,@,New England Patriots,28,13,252,0,300,3,0,15,-48,-3,False,True
2021-09-26,3,Sun,4:05PM,Denver Broncos,,New York Jets,26,0,343,1,162,2,0,26,181,-1,True,False
2021-09-26,3,Sun,4:05PM,Las Vegas Raiders,,Miami Dolphins,31,28,497,1,330,0,0,3,167,1,True,False
2021-09-26,3,Sun,4:25PM,Minnesota Vikings,,Seattle Seahawks,30,17,453,0,389,0,0,13,64,0,True,False
2021-09-26,3,Sun,4:25PM,Los Angeles Rams,,Tampa Bay Buccaneers,34,24,407,0,446,0,0,10,-39,0,True,False
2021-09-26,3,Sun,1:00PM,Baltimore Ravens,@,Detroit Lions,19,17,387,1,285,0,0,2,102,1,False,True
2021-09-27,3,Mon,8:15PM,Dallas Cowboys,,Philadelphia Eagles,41,21,380,1,367,2,0,20,13,-1,True,False
2021-09-30,4,Thu,8:20PM,Cincinnati Bengals,,Jacksonville Jaguars,24,21,420,0,341,0,0,3,79,0,True,False
2021-10-03,4,Sun,1:00PM,Washington Commanders,@,Atlanta Falcons,34,30,412,0,374,0,0,4,38,0,False,True
2021-10-03,4,Sun,1:00PM,Buffalo Bills,,Houston Texans,40,0,450,1,109,5,0,40,341,-4,True,False
2021-10-03,4,Sun,1:00PM,Dallas Cowboys,,Carolina Panthers,36,28,433,0,379,2,0,8,54,-2,True,False
2021-10-03,4,Sun,1:00PM,Chicago Bears,,Detroit Lions,24,14,373,1,351,2,0,10,22,-1,True,False
2021-10-03,4,Sun,1:00PM,Cleveland Browns,@,Minnesota Vikings,14,7,327,0,255,1,0,7,72,-1,False,True
2021-10-03,4,Sun,1:00PM,Kansas City Chiefs,@,Philadelphia Eagles,42,30,471,1,461,0,0,12,10,1,False,True
2021-10-03,4,Sun,1:00PM,New York Giants,@,New Orleans Saints,27,21,485,1,405,1,0,6,80,0,False,True
2021-10-03,4,Sun,1:00PM,New York Jets,,Tennessee Titans,27,24,355,1,430,0,0,3,-75,1,True,False
2021-10-03,4,Sun,4:05PM,Arizona Cardinals,@,Los Angeles Rams,37,20,465,0,401,2,0,17,64,-2,False,True
2021-10-03,4,Sun,4:05PM,Seattle Seahawks,@,San Francisco 49ers,28,21,234,0,457,2,0,7,-223,-2,False,True
2021-10-03,4,Sun,4:25PM,Baltimore Ravens,@,Denver Broncos,23,7,406,0,254,1,0,16,152,-1,False,True
2021-10-03,4,Sun,4:25PM,Green Bay Packers,,Pittsburgh Steelers,27,17,367,1,282,2,0,10,85,-1,True,False
2021-10-03,4,Sun,8:20PM,Tampa Bay Buccaneers,@,New England Patriots,19,17,381,0,294,2,0,2,87,-2,False,True
2021-10-03,4,Sun,1:00PM,Indianapolis Colts,@,Miami Dolphins,27,17,349,1,203,2,0,10,146,-1,False,True
2021-10-04,4,Mon,8:15PM,Los Angeles Chargers,,Las Vegas Raiders,28,14,380,0,213,1,0,14,167,-1,True,False
2021-10-07,5,Thu,8:20PM,Los Angeles Rams,@,Seattle Seahawks,26,17,476,1,354,2,0,9,122,-1,False,True
2021-10-10,5,Sun,1:00PM,Philadelphia Eagles,@,Carolina Panthers,21,18,273,2,267,3,0,3,6,-1,False,True
2021-10-10,5,Sun,9:30AM,Atlanta Falcons,,New York Jets,27,20,450,2,230,1,0,7,220,1,True,False
2021-10-10,5,Sun,8:20PM,Buffalo Bills,@,Kansas City Chiefs,38,20,436,0,392,4,0,18,44,-4,False,True
2021-10-10,5,Sun,4:25PM,Dallas Cowboys,,New York Giants,44,20,515,2,367,2,0,24,148,0,True,False
2021-10-10,5,Sun,4:25PM,Arizona Cardinals,,San Francisco 49ers,17,10,304,1,338,1,0,7,-34,0,True,False
2021-10-10,5,Sun,4:05PM,Chicago Bears,@,Las Vegas Raiders,20,9,252,0,259,1,0,11,-7,-1,False,True
2021-10-10,5,Sun,1:00PM,New Orleans Saints,@,Washington Commanders,33,22,369,2,373,2,0,11,-4,0,False,True
2021-10-10,5,Sun,4:05PM,Los Angeles Chargers,,Cleveland Browns,47,42,493,1,531,0,0,5,-38,1,True,False
2021-10-10,5,Sun,1:00PM,Tennessee Titans,@,Jacksonville Jaguars,37,19,368,0,454,2,0,18,-86,-2,False,True
2021-10-10,5,Sun,1:00PM,New England Patriots,@,Houston Texans,25,22,352,2,360,1,0,3,-8,1,False,True
2021-10-10,5,Sun,1:00PM,Minnesota Vikings,,Detroit Lions,19,17,384,2,288,2,0,2,96,0,True,False
2021-10-10,5,Sun,1:00PM,Pittsburgh Steelers,,Denver Broncos,27,19,391,1,374,1,0,8,17,0,True,False
2021-10-10,5,Sun,1:00PM,Green Bay Packers,@,Cincinnati Bengals,25,22,466,1,367,2,0,3,99,-1,False,True
2021-10-10,5,Sun,1:00PM,Tampa Bay Buccaneers,,Miami Dolphins,45,17,558,0,301,2,0,28,257,-2,True,False
2021-10-11,5,Mon,8:15PM,Baltimore Ravens,,Indianapolis Colts,31,25,523,1,513,1,0,6,10,0,True,False
2021-10-14,6,Thu,8:20PM,Tampa Bay Buccaneers,@,Philadelphia Eagles,28,22,399,1,213,1,0,6,186,0,False,True
2021-10-17,6,Sun,1:00PM,Baltimore Ravens,,Los Angeles Chargers,34,6,327,2,208,1,0,28,119,1,True,False
2021-10-17,6,Sun,4:25PM,Las Vegas Raiders,@,Denver Broncos,34,24,426,0,421,4,0,10,5,-4,False,True
2021-10-17,6,Sun,4:25PM,Dallas Cowboys,@,New England Patriots,35,29,567,2,335,2,0,6,232,0,False,True
2021-10-17,6,Sun,4:05PM,Arizona Cardinals,@,Cleveland Browns,37,14,352,0,290,3,0,23,62,-3,False,True
2021-10-17,6,Sun,1:00PM,Los Angeles Rams,@,New York Giants,38,11,365,2,261,4,0,27,104,-2,False,True
2021-10-17,6,Sun,8:20PM,Pittsburgh Steelers,,Seattle Seahawks,23,20,345,1,309,1,0,3,36,0,True,False
2021-10-17,6,Sun,1:00PM,Indianapolis Colts,,Houston Texans,31,3,388,0,353,3,0,28,35,-3,True,False
2021-10-17,6,Sun,1:00PM,Cincinnati Bengals,@,Detroit Lions,34,11,398,1,228,1,0,23,170,0,False,True
2021-10-17,6,Sun,1:00PM,Green Bay Packers,@,Chicago Bears,24,14,323,0,277,1,0,10,46,-1,False,True
2021-10-17,6,Sun,1:00PM,Minnesota Vikings,@,Carolina Panthers,34,28,571,1,306,3,0,6,265,-2,False,True
2021-10-17,6,Sun,9:30AM,Jacksonville Jaguars,,Miami Dolphins,23,20,396,1,431,1,0,3,-35,0,True,False
2021-10-17,6,Sun,1:00PM,Kansas City Chiefs,@,Washington Commanders,31,13,499,3,276,2,0,18,223,1,False,True
2021-10-18,6,Mon,8:15PM,Tennessee Titans,,Buffalo Bills,34,31,362,1,417,1,0,3,-55,0,True,False
2021-10-21,7,Thu,8:20PM,Cleveland Browns,,Denver Broncos,17,14,376,0,223,1,0,3,153,-1,True,False
2021-10-24,7,Sun,8:20PM,Indianapolis Colts,@,San Francisco 49ers,30,18,295,2,280,4,0,12,15,-2,False,True
2021-10-24,7,Sun,4:25PM,Tampa Bay Buccaneers,,Chicago Bears,38,3,408,1,311,5,0,35,97,-4,True,False
2021-10-24,7,Sun,4:05PM,Las Vegas Raiders,,Philadelphia Eagles,33,22,442,1,358,2,0,11,84,-1,True,False
2021-10-24,7,Sun,4:05PM,Los Angeles Rams,,Detroit Lions,28,19,374,0,415,2,0,9,-41,-2,True,False
2021-10-24,7,Sun,4:25PM,Arizona Cardinals,,Houston Texans,31,5,397,1,160,1,0,26,237,0,True,False
2021-10-24,7,Sun,1:00PM,Tennessee Titans,,Kansas City Chiefs,27,3,369,1,334,3,0,24,35,-2,True,False
2021-10-24,7,Sun,1:00PM,Green Bay Packers,,Washington Commanders,24,10,304,1,430,2,0,14,-126,-1,True,False
2021-10-24,7,Sun,1:00PM,Cincinnati Bengals,@,Baltimore Ravens,41,17,520,1,393,0,0,24,127,1,False,True
2021-10-24,7,Sun,1:00PM,New York Giants,,Carolina Panthers,25,3,302,0,173,1,0,22,129,-1,True,False
2021-10-24,7,Sun,1:00PM,Atlanta Falcons,@,Miami Dolphins,30,28,397,2,413,2,0,2,-16,0,False,True
2021-10-24,7,Sun,1:00PM,New England Patriots,,New York Jets,54,13,551,0,299,3,0,41,252,-3,True,False
2021-10-25,7,Mon,8:15PM,New Orleans Saints,@,Seattle Seahawks,13,10,304,1,219,0,0,3,85,1,False,True
2021-10-28,8,Thu,8:20PM,Green Bay Packers,@,Arizona Cardinals,24,21,335,0,334,3,0,3,1,-3,False,True
2021-10-31,8,Sun,4:25PM,New Orleans Saints,,Tampa Bay Buccaneers,36,27,361,0,421,3,0,9,-60,-3,True,False
2021-10-31,8,Sun,4:05PM,New England Patriots,@,Los Angeles Chargers,27,24,352,1,369,2,0,3,-17,-1,False,True
2021-10-31,8,Sun,4:05PM,Seattle Seahawks,,Jacksonville Jaguars,31,7,229,0,309,1,0,24,-80,-1,True,False
2021-10-31,8,Sun,1:00PM,Los Angeles Rams,@,Houston Texans,38,22,467,0,323,1,0,16,144,-1,False,True
2021-10-31,8,Sun,1:00PM,Philadelphia Eagles,@,Detroit Lions,44,6,350,0,228,1,0,38,122,-1,False,True
2021-10-31,8,Sun,1:00PM,San Francisco 49ers,@,Chicago Bears,33,22,467,0,324,1,0,11,143,-1,False,True
2021-10-31,8,Sun,1:00PM,Pittsburgh Steelers,@,Cleveland Browns,15,10,370,0,306,1,0,5,64,-1,False,True
2021-10-31,8,Sun,4:25PM,Denver Broncos,,Washington Commanders,17,10,273,1,342,2,0,7,-69,-1,True,False
2021-10-31,8,Sun,1:00PM,Buffalo Bills,,Miami Dolphins,26,11,351,0,262,2,0,15,89,-2,True,False
2021-10-31,8,Sun,1:00PM,Carolina Panthers,@,Atlanta Falcons,19,13,332,1,213,2,0,6,119,-1,False,True
2021-10-31,8,Sun,1:00PM,Tennessee Titans,@,Indianapolis Colts,34,31,340,2,307,3,0,3,33,-1,False,True
2021-10-31,8,Sun,8:20PM,Dallas Cowboys,@,Minnesota Vikings,20,16,419,2,278,0,0,4,141,2,False,True
2021-10-31,8,Sun,1:00PM,New York Jets,,Cincinnati Bengals,34,31,511,3,318,1,0,3,193,2,True,False
2021-11-01,8,Mon,8:15PM,Kansas City Chiefs,,New York Giants,20,17,368,2,300,1,0,3,68,1,True,False
2021-11-04,9,Thu,8:20PM,Indianapolis Colts,,New York Jets,45,30,532,0,486,2,0,15,46,-2,True,False
2021-11-07,9,Sun,1:00PM,Atlanta Falcons,@,New Orleans Saints,27,25,366,0,376,1,0,2,-10,-1,False,True
2021-11-07,9,Sun,8:20PM,Tennessee Titans,@,Los Angeles Rams,28,16,194,1,347,2,0,12,-153,-1,False,True
2021-11-07,9,Sun,4:25PM,Kansas City Chiefs,,Green Bay Packers,13,7,237,0,301,2,0,6,-64,-2,True,False
2021-11-07,9,Sun,4:05PM,Los Angeles Chargers,@,Philadelphia Eagles,27,24,445,0,331,0,0,3,114,0,False,True
2021-11-07,9,Sun,1:00PM,New York Giants,,Las Vegas Raiders,23,16,247,1,403,3,0,7,-156,-2,True,False
2021-11-07,9,Sun,1:00PM,Miami Dolphins,,Houston Texans,17,9,262,5,272,4,0,8,-10,1,True,False
2021-11-07,9,Sun,4:25PM,Arizona Cardinals,@,San Francisco 49ers,31,17,437,0,337,3,0,14,100,-3,False,True
2021-11-07,9,Sun,1:00PM,New England Patriots,@,Carolina Panthers,24,6,273,2,240,3,0,18,33,-1,False,True
2021-11-07,9,Sun,1:00PM,Baltimore Ravens,,Minnesota Vikings,34,31,500,2,318,0,0,3,182,2,True,False
2021-11-07,9,Sun,1:00PM,Denver Broncos,@,Dallas Cowboys,30,16,407,0,290,2,0,14,117,-2,False,True
2021-11-07,9,Sun,1:00PM,Jacksonville Jaguars,,Buffalo Bills,9,6,218,1,301,3,0,3,-83,-2,True,False
2021-11-07,9,Sun,1:00PM,Cleveland Browns,@,Cincinnati Bengals,41,16,361,0,348,3,0,25,13,-3,False,True
2021-11-08,9,Mon,8:15PM,Pittsburgh Steelers,,Chicago Bears,29,27,280,1,414,2,0,2,-134,-1,True,False
2021-11-11,10,Thu,8:20PM,Miami Dolphins,,Baltimore Ravens,22,10,350,0,304,2,0,12,46,-2,True,False
2021-11-14,10,Sun,1:00PM,Dallas Cowboys,,Atlanta Falcons,43,3,431,1,214,3,0,40,217,-2,True,False
2021-11-14,10,Sun,1:00PM,Buffalo Bills,@,New York Jets,45,17,489,2,366,5,0,28,123,-3,False,True
2021-11-14,10,Sun,1:00PM,Pittsburgh Steelers,,Detroit Lions,16,16,387,3,306,0,1,0,81,3,True,False
2021-11-14,10,Sun,1:00PM,Tennessee Titans,,New Orleans Saints,23,21,264,0,373,1,0,2,-109,-1,True,False
2021-11-14,10,Sun,1:00PM,Washington Commanders,,Tampa Bay Buccaneers,29,19,320,1,273,2,0,10,47,-1,True,False
2021-11-14,10,Sun,1:00PM,Indianapolis Colts,,Jacksonville Jaguars,23,17,295,0,331,1,0,6,-36,-1,True,False
2021-11-14,10,Sun,4:05PM,Minnesota Vikings,@,Los Angeles Chargers,27,20,381,1,253,1,0,7,128,0,False,True
2021-11-14,10,Sun,4:05PM,Carolina Panthers,@,Arizona Cardinals,34,10,341,2,169,2,0,24,172,0,False,True
2021-11-14,10,Sun,4:25PM,Philadelphia Eagles,@,Denver Broncos,30,13,386,1,308,1,0,17,78,0,False,True
2021-11-14,10,Sun,8:20PM,Kansas City Chiefs,@,Las Vegas Raiders,41,14,516,1,299,2,0,27,217,-1,False,True
2021-11-14,10,Sun,1:00PM,New England Patriots,,Cleveland Browns,45,7,452,0,217,1,0,38,235,-1,True,False
2021-11-14,10,Sun,4:25PM,Green Bay Packers,,Seattle Seahawks,17,0,393,1,208,2,0,17,185,-1,True,False
2021-11-15,10,Mon,8:15PM,San Francisco 49ers,,Los Angeles Rams,31,10,335,0,278,2,0,21,57,-2,True,False
2021-11-18,11,Thu,8:20PM,New England Patriots,@,Atlanta Falcons,25,0,308,1,165,4,0,25,143,-3,False,True
2021-11-21,11,Sun,8:20PM,Los Angeles Chargers,,Pittsburgh Steelers,41,37,533,1,300,0,0,4,233,1,True,False
2021-11-21,11,Sun,4:25PM,Arizona Cardinals,@,Seattle Seahawks,23,13,413,0,266,0,0,10,147,0,False,True
2021-11-21,11,Sun,1:00PM,Baltimore Ravens,@,Chicago Bears,16,13,299,1,353,1,0,3,-54,0,False,True
2021-11-21,11,Sun,1:00PM,Indianapolis Colts,@,Buffalo Bills,41,15,370,0,311,4,0,26,59,-4,False,True
2021-11-21,11,Sun,4:05PM,Cincinnati Bengals,@,Las Vegas Raiders,32,13,288,1,278,2,0,19,10,-1,False,True
2021-11-21,11,Sun,1:00PM,Miami Dolphins,@,New York Jets,24,17,388,1,380,1,0,7,8,0,False,True
2021-11-21,11,Sun,1:00PM,Minnesota Vikings,,Green Bay Packers,34,31,408,0,467,0,0,3,-59,0,True,False
2021-11-21,11,Sun,4:25PM,Kansas City Chiefs,,Dallas Cowboys,19,9,370,2,276,3,0,10,94,-1,True,False
2021-11-21,11,Sun,1:00PM,Washington Commanders,@,Carolina Panthers,27,21,369,1,297,0,0,6,72,1,False,True
2021-11-21,11,Sun,1:00PM,Philadelphia Eagles,,New Orleans Saints,40,29,380,1,323,3,0,11,57,-2,True,False
2021-11-21,11,Sun,1:00PM,San Francisco 49ers,@,Jacksonville Jaguars,30,10,333,0,200,2,0,20,133,-2,False,True
2021-11-21,11,Sun,1:00PM,Houston Texans,@,Tennessee Titans,22,13,190,0,420,5,0,9,-230,-5,False,True
2021-11-21,11,Sun,1:00PM,Cleveland Browns,,Detroit Lions,13,10,349,2,245,2,0,3,104,0,True,False
2021-11-22,11,Mon,8:15PM,Tampa Bay Buccaneers,,New York Giants,30,10,402,1,215,3,0,20,187,-2,True,False
2021-11-25,12,Thu,12:30PM,Chicago Bears,@,Detroit Lions,16,14,378,1,239,1,0,2,139,0,False,True
2021-11-25,12,Thu,4:30PM,Las Vegas Raiders,@,Dallas Cowboys,36,33,509,0,437,0,0,3,72,0,False,True
2021-11-25,12,Thu,8:20PM,Buffalo Bills,@,New Orleans Saints,31,6,361,2,190,1,0,25,171,1,False,True
2021-11-28,12,Sun,4:05PM,Denver Broncos,,Los Angeles Chargers,28,13,302,1,357,2,0,15,-55,-1,True,False
2021-11-28,12,Sun,8:20PM,Baltimore Ravens,,Cleveland Browns,16,10,303,4,262,2,0,6,41,2,True,False
2021-11-28,12,Sun,4:25PM,San Francisco 49ers,,Minnesota Vikings,34,26,423,1,323,2,0,8,100,-1,True,False
2021-11-28,12,Sun,1:00PM,New England Patriots,,Tennessee Titans,36,13,394,0,355,4,0,23,39,-4,True,False
2021-11-28,12,Sun,4:25PM,Green Bay Packers,,Los Angeles Rams,36,28,399,1,353,3,0,8,46,-2,True,False
2021-11-28,12,Sun,1:00PM,Miami Dolphins,,Carolina Panthers,33,10,315,1,198,3,0,23,117,-2,True,False
2021-11-28,12,Sun,1:00PM,New York Giants,,Philadelphia Eagles,13,7,264,0,332,4,0,6,-68,-4,True,False
2021-11-28,12,Sun,1:00PM,New York Jets,@,Houston Texans,21,14,266,1,202,1,0,7,64,0,False,True
2021-11-28,12,Sun,1:00PM,Cincinnati Bengals,,Pittsburgh Steelers,41,10,370,1,301,3,0,31,69,-2,True,False
2021-11-28,12,Sun,1:00PM,Atlanta Falcons,@,Jacksonville Jaguars,21,14,332,1,357,2,0,7,-25,-1,False,True
2021-11-28,12,Sun,1:00PM,Tampa Bay Buccaneers,@,Indianapolis Colts,38,31,359,2,392,5,0,7,-33,-3,False,True
2021-11-29,12,Mon,8:15PM,Washington Commanders,,Seattle Seahawks,17,15,371,1,267,1,0,2,104,0,True,False
2021-12-02,13,Thu,8:20PM,Dallas Cowboys,@,New Orleans Saints,27,17,377,1,405,4,0,10,-28,-3,False,True
2021-12-05,13,Sun,8:20PM,Kansas City Chiefs,,Denver Broncos,22,9,267,1,404,3,0,13,-137,-2,True,False
2021-12-05,13,Sun,4:25PM,Pittsburgh Steelers,,Baltimore Ravens,20,19,321,0,326,1,0,1,-5,-1,True,False
2021-12-05,13,Sun,4:25PM,Los Angeles Rams,,Jacksonville Jaguars,37,7,418,0,197,2,0,30,221,-2,True,False
2021-12-05,13,Sun,4:05PM,Washington Commanders,@,Las Vegas Raiders,17,15,298,1,310,0,0,2,-12,1,False,True
2021-12-05,13,Sun,4:00PM,Seattle Seahawks,,San Francisco 49ers,30,23,327,3,365,3,0,7,-38,0,True,False
2021-12-05,13,Sun,1:00PM,Miami Dolphins,,New York Giants,20,9,297,0,250,1,0,11,47,-1,True,False
2021-12-05,13,Sun,1:00PM,Philadelphia Eagles,@,New York Jets,33,18,418,0,281,1,0,15,137,-1,False,True
2021-12-05,13,Sun,1:00PM,Detroit Lions,,Minnesota Vikings,29,27,372,2,426,1,0,2,-54,1,True,False
2021-12-05,13,Sun,1:00PM,Los Angeles Chargers,@,Cincinnati Bengals,41,22,363,3,356,4,0,19,7,-1,False,True
2021-12-05,13,Sun,1:00PM,Arizona Cardinals,@,Chicago Bears,33,22,257,0,329,4,0,11,-72,-4,False,True
2021-12-05,13,Sun,1:00PM,Tampa Bay Buccaneers,@,Atlanta Falcons,30,17,425,1,380,1,0,13,45,0,False,True
2021-12-05,13,Sun,1:00PM,Indianapolis Colts,@,Houston Texans,31,0,389,1,141,2,0,31,248,-1,False,True
2021-12-06,13,Mon,8:15PM,New England Patriots,@,Buffalo Bills,14,10,241,1,230,1,0,4,11,0,False,True
2021-12-09,14,Thu,8:20PM,Minnesota Vikings,,Pittsburgh Steelers,36,28,458,2,375,1,0,8,83,1,True,False
2021-12-12,14,Sun,8:20PM,Green Bay Packers,,Chicago Bears,45,30,439,0,347,3,0,15,92,-3,True,False
2021-12-12,14,Sun,4:25PM,Tampa Bay Buccaneers,,Buffalo Bills,33,27,488,0,466,1,0,6,22,-1,True,False
2021-12-12,14,Sun,4:05PM,Los Angeles Chargers,,New York Giants,37,21,423,0,316,2,0,16,107,-2,True,False
2021-12-12,14,Sun,4:05PM,Denver Broncos,,Detroit Lions,38,10,358,0,316,2,0,28,42,-2,True,False
2021-12-12,14,Sun,1:00PM,Kansas City Chiefs,,Las Vegas Raiders,48,9,372,0,290,5,0,39,82,-5,True,False
2021-12-12,14,Sun,1:00PM,New Orleans Saints,@,New York Jets,30,9,344,0,256,0,0,21,88,0,False,True
2021-12-12,14,Sun,1:00PM,Seattle Seahawks,@,Houston Texans,33,13,453,0,380,0,0,20,73,0,False,True
2021-12-12,14,Sun,1:00PM,Dallas Cowboys,@,Washington Commanders,27,20,323,2,224,4,0,7,99,-2,False,True
2021-12-12,14,Sun,1:00PM,Cleveland Browns,,Baltimore Ravens,24,22,290,1,389,2,0,2,-99,-1,True,False
2021-12-12,14,Sun,1:00PM,San Francisco 49ers,@,Cincinnati Bengals,26,23,355,0,397,2,0,3,-42,-2,False,True
2021-12-12,14,Sun,1:00PM,Atlanta Falcons,@,Carolina Panthers,29,21,318,1,334,3,0,8,-16,-2,False,True
2021-12-12,14,Sun,1:00PM,Tennessee Titans,,Jacksonville Jaguars,20,0,263,0,192,4,0,20,71,-4,True,False
2021-12-13,14,Mon,8:15PM,Los Angeles Rams,@,Arizona Cardinals,30,23,356,0,447,2,0,7,-91,-2,False,True
2021-12-16,15,Thu,8:20PM,Kansas City Chiefs,@,Los Angeles Chargers,34,28,496,2,428,2,0,6,68,0,False,True
2021-12-18,15,Sat,8:20PM,Indianapolis Colts,,New England Patriots,27,17,275,1,365,2,0,10,-90,-1,True,False
2021-12-19,15,Sun,8:20PM,New Orleans Saints,@,Tampa Bay Buccaneers,9,0,212,0,302,2,0,9,-90,-2,False,True
2021-12-19,15,Sun,4:05PM,San Francisco 49ers,,Atlanta Falcons,31,13,397,1,275,1,0,18,122,0,True,False
2021-12-19,15,Sun,1:00PM,Pittsburgh Steelers,,Tennessee Titans,19,13,168,0,318,4,0,6,-150,-4,True,False
2021-12-19,15,Sun,1:00PM,Miami Dolphins,,New York Jets,31,24,379,3,228,1,0,7,151,2,True,False
2021-12-19,15,Sun,4:05PM,Cincinnati Bengals,@,Denver Broncos,15,10,249,0,292,1,0,5,-43,-1,False,True
2021-12-19,15,Sun,1:00PM,Green Bay Packers,@,Baltimore Ravens,31,30,346,0,354,0,0,1,-8,0,False,True
2021-12-19,15,Sun,1:00PM,Dallas Cowboys,@,New York Giants,21,6,328,1,302,4,0,15,26,-3,False,True
2021-12-19,15,Sun,1:00PM,Detroit Lions,,Arizona Cardinals,30,12,338,1,398,1,0,18,-60,0,True,False
2021-12-19,15,Sun,1:00PM,Buffalo Bills,,Carolina Panthers,31,14,312,1,275,1,0,17,37,0,True,False
2021-12-19,15,Sun,1:00PM,Houston Texans,@,Jacksonville Jaguars,30,16,281,1,296,0,0,14,-15,1,False,True
2021-12-20,15,Mon,5:00PM,Las Vegas Raiders,@,Cleveland Browns,16,14,328,2,236,0,0,2,92,2,False,True
2021-12-20,15,Mon,8:15PM,Minnesota Vikings,@,Chicago Bears,17,9,193,1,370,3,0,8,-177,-2,False,True
2021-12-21,15,Tue,7:00PM,Philadelphia Eagles,,Washington Commanders,27,17,519,2,237,0,0,10,282,2,True,False
2021-12-21,15,Tue,7:00PM,Los Angeles Rams,,Seattle Seahawks,20,10,332,1,214,1,0,10,118,0,True,False
2021-12-23,16,Thu,8:20PM,Tennessee Titans,,San Francisco 49ers,20,17,278,0,389,2,0,3,-111,-2,True,False
2021-12-25,16,Sat,4:30PM,Green Bay Packers,,Cleveland Browns,24,22,311,0,408,4,0,2,-97,-4,True,False
2021-12-25,16,Sat,8:15PM,Indianapolis Colts,@,Arizona Cardinals,22,16,346,0,378,0,0,6,-32,0,False,True
2021-12-26,16,Sun,4:05PM,Chicago Bears,@,Seattle Seahawks,25,24,317,0,331,0,0,1,-14,0,False,True
2021-12-26,16,Sun,8:20PM,Dallas Cowboys,,Washington Commanders,56,14,497,0,257,2,0,42,240,-2,True,False
2021-12-26,16,Sun,4:25PM,Kansas City Chiefs,,Pittsburgh Steelers,36,10,381,0,303,3,0,26,78,-3,True,False
2021-12-26,16,Sun,4:25PM,Las Vegas Raiders,,Denver Broncos,17,13,342,3,158,0,0,4,184,3,True,False
2021-12-26,16,Sun,1:00PM,Philadelphia Eagles,,New York Giants,34,10,324,0,192,2,0,24,132,-2,True,False
2021-12-26,16,Sun,1:00PM,New York Jets,,Jacksonville Jaguars,26,21,373,0,384,1,0,5,-11,-1,True,False
2021-12-26,16,Sun,1:00PM,Houston Texans,,Los Angeles Chargers,41,29,437,0,417,3,0,12,20,-3,True,False
2021-12-26,16,Sun,1:00PM,Cincinnati Bengals,,Baltimore Ravens,41,21,575,0,334,1,0,20,241,-1,True,False
2021-12-26,16,Sun,1:00PM,Tampa Bay Buccaneers,@,Carolina Panthers,32,6,391,0,273,1,0,26,118,-1,False,True
2021-12-26,16,Sun,1:00PM,Buffalo Bills,@,New England Patriots,33,21,428,0,288,2,0,12,140,-2,False,True
2021-12-26,16,Sun,1:00PM,Atlanta Falcons,,Detroit Lions,20,16,254,1,338,1,0,4,-84,0,True,False
2021-12-26,16,Sun,1:00PM,Los Angeles Rams,@,Minnesota Vikings,30,23,356,3,361,1,0,7,-5,2,False,True
2021-12-27,16,Mon,8:15PM,Miami Dolphins,@,New Orleans Saints,20,3,259,1,164,2,0,17,95,-1,False,True
2022-01-02,17,Sun,4:05PM,Los Angeles Chargers,,Denver Broncos,34,13,341,0,319,1,0,21,22,-1,True,False
2022-01-02,17,Sun,8:20PM,Green Bay Packers,,Minnesota Vikings,37,10,481,0,206,0,0,27,275,0,True,False
2022-01-02,17,Sun,4:25PM,Los Angeles Rams,@,Baltimore Ravens,20,19,373,3,327,2,0,1,46,1,False,True
2022-01-02,17,Sun,4:25PM,Seattle Seahawks,,Detroit Lions,51,29,497,0,357,3,0,22,140,-3,True,False
2022-01-02,17,Sun,4:25PM,Arizona Cardinals,@,Dallas Cowboys,25,22,399,0,301,1,0,3,98,-1,False,True
2022-01-02,17,Sun,1:00PM,Philadelphia Eagles,@,Washington Commanders,20,16,330,0,312,1,0,4,18,-1,False,True
2022-01-02,17,Sun,4:05PM,San Francisco 49ers,,Houston Texans,23,7,416,1,222,1,0,16,194,0,True,False
2022-01-02,17,Sun,1:00PM,Tennessee Titans,,Miami Dolphins,34,3,308,0,256,2,0,31,52,-2,True,False
2022-01-02,17,Sun,1:00PM,Tampa Bay Buccaneers,@,New York Jets,28,24,467,1,374,1,0,4,93,0,False,True
2022-01-02,17,Sun,1:00PM,Buffalo Bills,,Atlanta Falcons,29,15,351,3,265,1,0,14,86,2,True,False
2022-01-02,17,Sun,1:00PM,New Orleans Saints,,Carolina Panthers,18,10,280,0,178,2,0,8,102,-2,True,False
2022-01-02,17,Sun,1:00PM,Cincinnati Bengals,,Kansas City Chiefs,34,31,475,0,414,0,0,3,61,0,True,False
2022-01-02,17,Sun,1:00PM,Las Vegas Raiders,@,Indianapolis Colts,23,20,326,2,262,0,0,3,64,2,False,True
2022-01-02,17,Sun,1:00PM,Chicago Bears,,New York Giants,29,3,249,2,155,4,0,26,94,-2,True,False
2022-01-02,17,Sun,1:00PM,New England Patriots,,Jacksonville Jaguars,50,10,471,0,253,3,0,40,218,-3,True,False
2022-01-03,17,Mon,8:15PM,Pittsburgh Steelers,,Cleveland Browns,26,14,299,1,232,2,0,12,67,-1,True,False
2022-01-08,18,Sat,4:30PM,Kansas City Chiefs,@,Denver Broncos,28,24,390,0,364,1,0,4,26,-1,False,True
2022-01-08,18,Sat,8:15PM,Dallas Cowboys,@,Philadelphia Eagles,51,26,475,0,315,1,0,25,160,-1,False,True
2022-01-09,18,Sun,8:25PM,Las Vegas Raiders,,Los Angeles Chargers,35,32,346,0,440,2,0,3,-94,-2,True,False
2022-01-09,18,Sun,4:25PM,San Francisco 49ers,@,Los Angeles Rams,27,24,449,2,265,2,0,3,184,0,False,True
2022-01-09,18,Sun,4:25PM,Seattle Seahawks,@,Arizona Cardinals,38,30,431,2,305,1,0,8,126,1,False,True
2022-01-09,18,Sun,1:00PM,Pittsburgh Steelers,@,Baltimore Ravens,16,13,314,1,381,3,0,3,-67,-2,False,True
2022-01-09,18,Sun,1:00PM,Miami Dolphins,,New England Patriots,33,24,298,0,379,3,0,9,-81,-3,True,False
2022-01-09,18,Sun,4:25PM,Buffalo Bills,,New York Jets,27,10,424,0,53,0,0,17,371,0,True,False
2022-01-09,18,Sun,1:00PM,Detroit Lions,,Green Bay Packers,37,30,404,0,378,3,0,7,26,-3,True,False
2022-01-09,18,Sun,1:00PM,Tennessee Titans,@,Houston Texans,28,25,405,0,353,0,0,3,52,0,False,True
2022-01-09,18,Sun,1:00PM,New Orleans Saints,@,Atlanta Falcons,30,20,369,0,257,3,0,10,112,-3,False,True
2022-01-09,18,Sun,1:00PM,Tampa Bay Buccaneers,,Carolina Panthers,41,17,409,0,317,2,0,24,92,-2,True,False
2022-01-09,18,Sun,1:00PM,Washington Commanders,@,New York Giants,22,7,325,0,177,3,0,15,148,-3,False,True
2022-01-09,18,Sun,1:00PM,Cleveland Browns,,Cincinnati Bengals,21,16,376,2,182,0,0,5,194,2,True,False
2022-01-09,18,Sun,1:00PM,Jacksonville Jaguars,,Indianapolis Colts,26,11,318,0,233,2,0,15,85,-2,True,False
2022-01-09,18,Sun,1:00PM,Minnesota Vikings,,Chicago Bears,31,17,331,0,356,2,0,14,-25,-2,True,False
2022-01-15,WildCard,Sat,4:30PM,Cincinnati Bengals,,Las Vegas Raiders,26,19,308,0,385,2,0,7,-77,-2,True,False
2022-01-15,WildCard,Sat,8:15PM,Buffalo Bills,,New England Patriots,47,17,482,0,305,2,0,30,177,-2,True,False
2022-01-16,WildCard,Sun,4:40PM,San Francisco 49ers,@,Dallas Cowboys,23,17,341,1,307,1,0,6,34,0,False,True
2022-01-16,WildCard,Sun,8:15PM,Kansas City Chiefs,,Pittsburgh Steelers,42,21,478,2,257,1,0,21,221,1,True,False
2022-01-16,WildCard,Sun,1:00PM,Tampa Bay Buccaneers,,Philadelphia Eagles,31,15,349,0,339,3,0,16,10,-3,True,False
2022-01-17,WildCard,Mon,8:15PM,Los Angeles Rams,,Arizona Cardinals,34,11,375,0,183,2,0,23,192,-2,True,False
2022-01-22,Division,Sat,4:30PM,Cincinnati Bengals,@,Tennessee Titans,19,16,345,1,353,3,0,3,-8,-2,False,True
2022-01-22,Division,Sat,8:15PM,San Francisco 49ers,@,Green Bay Packers,13,10,212,1,263,1,0,3,-51,0,False,True
2022-01-23,Division,Sun,3:00PM,Los Angeles Rams,@,Tampa Bay Buccaneers,30,27,428,4,359,2,0,3,69,2,False,True
2022-01-23,Division,Sun,6:30PM,Kansas City Chiefs,,Buffalo Bills,42,36,552,0,422,0,0,6,130,0,True,False
2022-01-30,ConfChamp,Sun,6:30PM,Los Angeles Rams,,San Francisco 49ers,20,17,396,1,282,1,0,3,114,0,True,False
2022-01-30,ConfChamp,Sun,3:00PM,Cincinnati Bengals,@,Kansas City Chiefs,27,24,359,1,375,2,0,3,-16,-1,False,True
2022-02-13,SuperBowl,Sun,6:30PM,Los Angeles Rams,N,Cincinnati Bengals,23,20,313,2,305,0,0,3,8,2,False,False
2022-09-08,1,Thu,8:20PM,Buffalo Bills,@,Los Angeles Rams,31,10,413,4,243,3,0,21,170,1,False,True
2022-09-11,1,Sun,8:20PM,Tampa Bay Buccaneers,@,Dallas Cowboys,19,3,347,1,244,1,0,16,103,0,False,True
2022-09-11,1,Sun,4:25PM,Los Angeles Chargers,,Las Vegas Raiders,24,19,355,0,320,3,0,5,35,-3,True,False
2022-09-11,1,Sun,4:25PM,New York Giants,@,Tennessee Titans,21,20,394,2,359,1,0,1,35,1,False,True
2022-09-11,1,Sun,4:25PM,Kansas City Chiefs,@,Arizona Cardinals,44,21,488,1,282,0,0,23,206,1,False,True
2022-09-11,1,Sun,1:00PM,Baltimore Ravens,@,New York Jets,24,9,274,1,380,2,0,15,-106,-1,False,True
2022-09-11,1,Sun,1:00PM,Miami Dolphins,,New England Patriots,20,7,307,0,271,3,0,13,36,-3,True,False
2022-09-11,1,Sun,4:25PM,Minnesota Vikings,,Green Bay Packers,23,7,395,0,338,2,0,16,57,-2,True,False
2022-09-11,1,Sun,1:00PM,Philadelphia Eagles,@,Detroit Lions,38,35,455,0,386,1,0,3,69,-1,False,True
2022-09-11,1,Sun,1:00PM,Houston Texans,,Indianapolis Colts,20,20,299,1,517,2,1,0,-218,-1,True,False
2022-09-11,1,Sun,1:00PM,Pittsburgh Steelers,@,Cincinnati Bengals,23,20,267,0,432,5,0,3,-165,-5,False,True
2022-09-11,1,Sun,1:00PM,Chicago Bears,,San Francisco 49ers,19,10,204,1,331,2,0,9,-127,-1,True,False
2022-09-11,1,Sun,1:00PM,Cleveland Browns,@,Carolina Panthers,26,24,355,0,261,1,0,2,94,-1,False,True
2022-09-11,1,Sun,1:00PM,New Orleans Saints,@,Atlanta Falcons,27,26,385,1,416,2,0,1,-31,-1,False,True
2022-09-11,1,Sun,1:00PM,Washington Commanders,,Jacksonville Jaguars,28,22,390,3,383,1,0,6,7,2,True,False
2022-09-12,1,Mon,8:20PM,Seattle Seahawks,,Denver Broncos,17,16,253,1,433,2,0,1,-180,-1,True,False
2022-09-15,2,Thu,8:15PM,Kansas City Chiefs,,Los Angeles Chargers,27,24,319,0,401,1,0,3,-82,-1,True,False
2022-09-18,2,Sun,4:05PM,San Francisco 49ers,,Seattle Seahawks,27,7,373,0,216,3,0,20,157,-3,True,False
2022-09-18,2,Sun,8:20PM,Green Bay Packers,,Chicago Bears,27,10,414,1,228,1,0,17,186,0,True,False
2022-09-18,2,Sun,4:25PM,Denver Broncos,,Houston Texans,16,9,350,1,234,0,0,7,116,1,True,False
2022-09-18,2,Sun,4:25PM,Arizona Cardinals,@,Las Vegas Raiders,29,23,413,1,324,1,0,6,89,0,False,True
2022-09-18,2,Sun,4:25PM,Dallas Cowboys,,Cincinnati Bengals,20,17,337,1,254,0,0,3,83,1,True,False
2022-09-18,2,Sun,4:05PM,Los Angeles Rams,,Atlanta Falcons,31,27,337,3,261,3,0,4,76,0,True,False
2022-09-18,2,Sun,1:00PM,Jacksonville Jaguars,,Indianapolis Colts,24,0,331,0,218,3,0,24,113,-3,True,False
2022-09-18,2,Sun,1:00PM,Tampa Bay Buccaneers,@,New Orleans Saints,20,10,260,1,308,5,0,10,-48,-4,False,True
2022-09-18,2,Sun,1:00PM,Miami Dolphins,@,Baltimore Ravens,42,38,547,2,473,0,0,4,74,2,False,True
2022-09-18,2,Sun,1:00PM,Detroit Lions,,Washington Commanders,36,27,425,0,396,1,0,9,29,-1,True,False
2022-09-18,2,Sun,1:00PM,New York Jets,@,Cleveland Browns,31,30,402,1,405,1,0,1,-3,0,False,True
2022-09-18,2,Sun,1:00PM,New York Giants,,Carolina Panthers,19,16,265,0,275,2,0,3,-10,-2,True,False
2022-09-18,2,Sun,1:00PM,New England Patriots,@,Pittsburgh Steelers,17,14,376,1,243,2,0,3,133,-1,False,True
2022-09-19,2,Mon,7:15PM,Buffalo Bills,,Tennessee Titans,41,7,414,0,187,4,0,34,227,-4,True,False
2022-09-19,2,Mon,8:30PM,Philadelphia Eagles,,Minnesota Vikings,24,7,486,1,264,3,0,17,222,-2,True,False
2022-09-22,3,Thu,8:15PM,Cleveland Browns,,Pittsburgh Steelers,29,17,376,0,308,1,0,12,68,-1,True,False
2022-09-25,3,Sun,4:05PM,Jacksonville Jaguars,@,Los Angeles Chargers,38,10,413,0,312,2,0,28,101,-2,False,True
2022-09-25,3,Sun,8:20PM,Denver Broncos,,San Francisco 49ers,11,10,261,0,267,3,0,1,-6,-3,True,False
2022-09-25,3,Sun,4:25PM,Green Bay Packers,@,Tampa Bay Buccaneers,14,12,315,2,285,2,0,2,30,0,False,True
2022-09-25,3,Sun,4:25PM,Los Angeles Rams,@,Arizona Cardinals,20,12,339,1,365,0,0,8,-26,1,False,True
2022-09-25,3,Sun,4:25PM,Atlanta Falcons,@,Seattle Seahawks,27,23,386,2,420,1,0,4,-34,1,False,True
2022-09-25,3,Sun,1:00PM,Philadelphia Eagles,@,Washington Commanders,24,8,400,0,240,1,0,16,160,-1,False,True
2022-09-25,3,Sun,1:00PM,Chicago Bears,,Houston Texans,23,20,363,2,329,2,0,3,34,0,True,False
2022-09-25,3,Sun,1:00PM,Baltimore Ravens,@,New England Patriots,37,26,394,2,447,4,0,11,-53,-2,False,True
2022-09-25,3,Sun,1:00PM,Minnesota Vikings,,Detroit Lions,28,24,373,1,416,1,0,4,-43,0,True,False
2022-09-25,3,Sun,1:00PM,Indianapolis Colts,,Kansas City Chiefs,20,17,259,1,315,2,0,3,-56,-1,True,False
2022-09-25,3,Sun,1:00PM,Cincinnati Bengals,@,New York Jets,27,12,330,1,328,4,0,15,2,-3,False,True
2022-09-25,3,Sun,1:00PM,Miami Dolphins,,Buffalo Bills,21,19,212,0,497,1,0,2,-285,-1,True,False
2022-09-25,3,Sun,1:00PM,Carolina Panthers,,New Orleans Saints,22,14,293,0,426,3,0,8,-133,-3,True,False
2022-09-25,3,Sun,1:00PM,Tennessee Titans,,Las Vegas Raiders,24,22,361,1,396,1,0,2,-35,0,True,False
2022-09-26,3,Mon,8:15PM,Dallas Cowboys,@,New York Giants,23,16,391,0,336,1,0,7,55,-1,False,True
2022-09-29,4,Thu,8:15PM,Cincinnati Bengals,,Miami Dolphins,27,15,371,0,378,2,0,12,-7,-2,True,False
2022-10-02,4,Sun,8:20PM,Kansas City Chiefs,@,Tampa Bay Buccaneers,41,31,417,1,376,2,0,10,41,-1,False,True
2022-10-02,4,Sun,4:25PM,Green Bay Packers,,New England Patriots,27,24,443,2,271,1,0,3,172,1,True,False
2022-10-02,4,Sun,4:25PM,Las Vegas Raiders,,Denver Broncos,32,23,385,0,299,1,0,9,86,-1,True,False
2022-10-02,4,Sun,4:05PM,Arizona Cardinals,@,Carolina Panthers,26,16,338,1,220,3,0,10,118,-2,False,True
2022-10-02,4,Sun,1:00PM,New York Jets,@,Pittsburgh Steelers,24,20,348,2,297,4,0,4,51,-2,False,True
2022-10-02,4,Sun,1:00PM,Philadelphia Eagles,,Jacksonville Jaguars,29,21,401,1,219,5,0,8,182,-4,True,False
2022-10-02,4,Sun,1:00PM,Los Angeles Chargers,@,Houston Texans,34,24,419,1,346,2,0,10,73,-1,False,True
2022-10-02,4,Sun,1:00PM,Dallas Cowboys,,Washington Commanders,25,10,279,0,297,2,0,15,-18,-2,True,False
2022-10-02,4,Sun,1:00PM,Tennessee Titans,@,Indianapolis Colts,24,17,243,0,365,3,0,7,-122,-3,False,True
2022-10-02,4,Sun,1:00PM,New York Giants,,Chicago Bears,20,12,333,2,304,3,0,8,29,-1,True,False
2022-10-02,4,Sun,1:00PM,Buffalo Bills,@,Baltimore Ravens,23,20,326,2,296,2,0,3,30,0,False,True
2022-10-02,4,Sun,1:00PM,Atlanta Falcons,,Cleveland Browns,23,20,333,1,403,2,0,3,-70,-1,True,False
2022-10-02,4,Sun,9:30AM,Minnesota Vikings,@,New Orleans Saints,28,25,344,1,338,2,0,3,6,-1,False,True
2022-10-02,4,Sun,1:00PM,Seattle Seahawks,@,Detroit Lions,48,45,555,1,520,2,0,3,35,-1,False,True
2022-10-03,4,Mon,8:15PM,San Francisco 49ers,,Los Angeles Rams,24,9,327,0,257,2,0,15,70,-2,True,False
2022-10-06,5,Thu,8:15PM,Indianapolis Colts,@,Denver Broncos,12,9,306,2,375,2,0,3,-69,0,False,True
2022-10-09,5,Sun,1:00PM,New Orleans Saints,,Seattle Seahawks,39,32,438,2,396,1,0,7,42,1,True,False
2022-10-09,5,Sun,1:00PM,Tennessee Titans,@,Washington Commanders,21,17,241,0,385,1,0,4,-144,-1,False,True
2022-10-09,5,Sun,8:20PM,Baltimore Ravens,,Cincinnati Bengals,19,17,325,1,291,1,0,2,34,0,True,False
2022-10-09,5,Sun,4:05PM,San Francisco 49ers,@,Carolina Panthers,37,15,397,1,308,1,0,22,89,0,False,True
2022-10-09,5,Sun,4:25PM,Philadelphia Eagles,@,Arizona Cardinals,20,17,357,0,363,1,0,3,-6,-1,False,True
2022-10-09,5,Sun,4:25PM,Dallas Cowboys,@,Los Angeles Rams,22,10,239,0,323,3,0,12,-84,-3,False,True
2022-10-09,5,Sun,1:00PM,New York Jets,,Miami Dolphins,40,17,322,0,295,2,0,23,27,-2,True,False
2022-10-09,5,Sun,1:00PM,Houston Texans,@,Jacksonville Jaguars,13,6,248,0,422,2,0,7,-174,-2,False,True
2022-10-09,5,Sun,9:30AM,New York Giants,@,Green Bay Packers,27,22,338,0,301,0,0,5,37,0,False,True
2022-10-09,5,Sun,1:00PM,Tampa Bay Buccaneers,,Atlanta Falcons,21,15,420,0,261,0,0,6,159,0,True,False
2022-10-09,5,Sun,1:00PM,Buffalo Bills,,Pittsburgh Steelers,38,3,552,2,364,2,0,35,188,0,True,False
2022-10-09,5,Sun,1:00PM,Minnesota Vikings,,Chicago Bears,29,22,429,1,271,1,0,7,158,0,True,False
2022-10-09,5,Sun,1:00PM,Los Angeles Chargers,@,Cleveland Browns,30,28,465,0,443,1,0,2,22,-1,False,True
2022-10-09,5,Sun,1:00PM,New England Patriots,,Detroit Lions,29,0,364,1,312,2,0,29,52,-1,True,False
2022-10-10,5,Mon,8:15PM,Kansas City Chiefs,,Las Vegas Raiders,30,29,368,0,378,0,0,1,-10,0,True,False
2022-10-13,6,Thu,8:15PM,Washington Commanders,@,Chicago Bears,12,7,214,0,391,2,0,5,-177,-2,False,True
2022-10-16,6,Sun,8:20PM,Philadelphia Eagles,,Dallas Cowboys,26,17,268,0,315,3,0,9,-47,-3,True,False
2022-10-16,6,Sun,4:25PM,Buffalo Bills,@,Kansas City Chiefs,24,20,443,1,387,2,0,4,56,-1,False,True
2022-10-16,6,Sun,4:05PM,Seattle Seahawks,,Arizona Cardinals,19,9,296,1,315,2,0,10,-19,-1,True,False
2022-10-16,6,Sun,4:05PM,Los Angeles Rams,,Carolina Panthers,24,10,360,1,203,1,0,14,157,0,True,False
2022-10-16,6,Sun,1:00PM,Pittsburgh Steelers,,Tampa Bay Buccaneers,20,18,270,0,304,0,0,2,-34,0,True,False
2022-10-16,6,Sun,1:00PM,New York Giants,,Baltimore Ravens,24,20,238,1,406,2,0,4,-168,-1,True,False
2022-10-16,6,Sun,1:00PM,New York Jets,@,Green Bay Packers,27,10,278,0,278,1,0,17,0,-1,False,True
2022-10-16,6,Sun,1:00PM,Indianapolis Colts,,Jacksonville Jaguars,34,27,434,0,379,1,0,7,55,-1,True,False
2022-10-16,6,Sun,1:00PM,New England Patriots,@,Cleveland Browns,38,15,399,1,328,4,0,23,71,-3,False,True
2022-10-16,6,Sun,1:00PM,Cincinnati Bengals,@,New Orleans Saints,30,26,348,1,399,0,0,4,-51,1,False,True
2022-10-16,6,Sun,1:00PM,Atlanta Falcons,,San Francisco 49ers,28,14,289,0,346,3,0,14,-57,-3,True,False
2022-10-16,6,Sun,1:00PM,Minnesota Vikings,@,Miami Dolphins,24,16,234,0,458,3,0,8,-224,-3,False,True
2022-10-17,6,Mon,8:15PM,Los Angeles Chargers,,Denver Broncos,19,16,297,1,258,1,0,3,39,0,True,False
2022-10-20,7,Thu,8:15PM,Arizona Cardinals,,New Orleans Saints,42,34,326,0,494,3,0,8,-168,-3,True,False
2022-10-23,7,Sun,1:00PM,New York Giants,@,Jacksonville Jaguars,23,17,436,0,452,1,0,6,-16,-1,False,True
2022-10-23,7,Sun,8:20PM,Miami Dolphins,,Pittsburgh Steelers,16,10,372,0,341,3,0,6,31,-3,True,False
2022-10-23,7,Sun,4:25PM,Kansas City Chiefs,@,San Francisco 49ers,44,23,529,2,444,3,0,21,85,-1,False,True
2022-10-23,7,Sun,4:05PM,New York Jets,@,Denver Broncos,16,9,260,0,324,1,0,7,-64,-1,False,True
2022-10-23,7,Sun,4:05PM,Las Vegas Raiders,,Houston Texans,38,20,400,0,404,1,0,18,-4,-1,True,False
2022-10-23,7,Sun,1:00PM,Washington Commanders,,Green Bay Packers,23,21,364,1,232,1,0,2,132,0,True,False
2022-10-23,7,Sun,4:25PM,Seattle Seahawks,@,Los Angeles Chargers,37,23,404,2,329,2,0,14,75,0,False,True
2022-10-23,7,Sun,1:00PM,Tennessee Titans,,Indianapolis Colts,19,10,254,1,292,3,0,9,-38,-2,True,False
2022-10-23,7,Sun,1:00PM,Baltimore Ravens,,Cleveland Browns,23,20,254,1,336,2,0,3,-82,-1,True,False
2022-10-23,7,Sun,1:00PM,Carolina Panthers,,Tampa Bay Buccaneers,21,3,343,0,322,0,0,18,21,0,True,False
2022-10-23,7,Sun,1:00PM,Cincinnati Bengals,,Atlanta Falcons,35,17,537,0,214,0,0,18,323,0,True,False
2022-10-23,7,Sun,1:00PM,Dallas Cowboys,,Detroit Lions,24,6,330,1,312,5,0,18,18,-4,True,False
2022-10-24,7,Mon,8:15PM,Chicago Bears,@,New England Patriots,33,14,390,1,260,4,0,19,130,-3,False,True
2022-10-27,8,Thu,8:15PM,Baltimore Ravens,@,Tampa Bay Buccaneers,27,22,453,0,349,1,0,5,104,-1,False,True
2022-10-30,8,Sun,8:20PM,Buffalo Bills,,Green Bay Packers,27,17,369,2,398,1,0,10,-29,1,True,False
2022-10-30,8,Sun,4:25PM,San Francisco 49ers,@,Los Angeles Rams,31,14,368,0,223,0,0,17,145,0,False,True
2022-10-30,8,Sun,4:05PM,Tennessee Titans,@,Houston Texans,17,10,354,2,161,1,0,7,193,1,False,True
2022-10-30,8,Sun,4:25PM,Seattle Seahawks,,New York Giants,27,13,277,1,225,2,0,14,52,-1,True,False
2022-10-30,8,Sun,4:25PM,Washington Commanders,@,Indianapolis Colts,17,16,362,1,324,2,0,1,38,-1,False,True
2022-10-30,8,Sun,1:00PM,Minnesota Vikings,,Arizona Cardinals,34,26,381,1,375,3,0,8,6,-2,True,False
2022-10-30,8,Sun,1:00PM,New England Patriots,@,New York Jets,22,17,288,1,387,3,0,5,-99,-2,False,True
2022-10-30,8,Sun,1:00PM,Atlanta Falcons,,Carolina Panthers,37,34,406,2,478,1,0,3,-72,1,True,False
2022-10-30,8,Sun,1:00PM,Philadelphia Eagles,,Pittsburgh Steelers,35,13,401,0,302,2,0,22,99,-2,True,False
2022-10-30,8,Sun,1:00PM,Miami Dolphins,@,Detroit Lions,31,27,476,1,393,0,0,4,83,1,False,True
2022-10-30,8,Sun,9:30AM,Denver Broncos,@,Jacksonville Jaguars,21,17,331,1,305,2,0,4,26,-1,False,True
2022-10-30,8,Sun,1:00PM,New Orleans Saints,,Las Vegas Raiders,24,0,367,0,183,1,0,24,184,-1,True,False
2022-10-30,8,Sun,1:00PM,Dallas Cowboys,,Chicago Bears,49,29,442,1,371,1,0,20,71,0,True,False
2022-10-31,8,Mon,8:15PM,Cleveland Browns,,Cincinnati Bengals,32,13,440,2,229,2,0,19,211,0,True,False
2022-11-03,9,Thu,8:15PM,Philadelphia Eagles,@,Houston Texans,29,17,360,1,303,2,0,12,57,-1,False,True
2022-11-06,9,Sun,8:20PM,Kansas City Chiefs,,Tennessee Titans,20,17,499,1,229,0,0,3,270,1,True,False
2022-11-06,9,Sun,4:25PM,Tampa Bay Buccaneers,,Los Angeles Rams,16,13,323,0,206,0,0,3,117,0,True,False
2022-11-06,9,Sun,4:05PM,Seattle Seahawks,@,Arizona Cardinals,31,21,421,1,262,1,0,10,159,0,False,True
2022-11-06,9,Sun,1:00PM,Jacksonville Jaguars,,Las Vegas Raiders,27,20,403,1,321,1,0,7,82,0,True,False
2022-11-06,9,Sun,1:00PM,New England Patriots,,Indianapolis Colts,26,3,203,1,121,1,0,23,82,0,True,False
2022-11-06,9,Sun,1:00PM,Miami Dolphins,@,Chicago Bears,35,32,379,0,368,0,0,3,11,0,False,True
2022-11-06,9,Sun,1:00PM,Los Angeles Chargers,@,Atlanta Falcons,20,17,336,2,315,2,0,3,21,0,False,True
2022-11-06,9,Sun,1:00PM,Minnesota Vikings,@,Washington Commanders,20,17,301,1,263,1,0,3,38,0,False,True
2022-11-06,9,Sun,1:00PM,Detroit Lions,,Green Bay Packers,15,9,254,1,389,3,0,6,-135,-2,True,False
2022-11-06,9,Sun,1:00PM,New York Jets,,Buffalo Bills,20,17,310,1,317,2,0,3,-7,-1,True,False
2022-11-06,9,Sun,1:00PM,Cincinnati Bengals,,Carolina Panthers,42,21,464,0,228,3,0,21,236,-3,True,False
2022-11-07,9,Mon,8:15PM,Baltimore Ravens,@,New Orleans Saints,27,13,319,0,243,1,0,14,76,-1,False,True
2022-11-10,10,Thu,8:15PM,Carolina Panthers,,Atlanta Falcons,25,15,333,0,291,1,0,10,42,-1,True,False
2022-11-13,10,Sun,9:30AM,Tampa Bay Buccaneers,,Seattle Seahawks,21,16,419,2,283,1,0,5,136,1,True,False
2022-11-13,10,Sun,1:00PM,Minnesota Vikings,@,Buffalo Bills,33,30,481,2,486,4,0,3,-5,-2,False,True
2022-11-13,10,Sun,1:00PM,Miami Dolphins,,Cleveland Browns,39,17,491,0,297,1,0,22,194,-1,True,False
2022-11-13,10,Sun,1:00PM,New York Giants,,Houston Texans,24,16,367,0,387,2,0,8,-20,-2,True,False
2022-11-13,10,Sun,1:00PM,Tennessee Titans,,Denver Broncos,17,10,307,1,313,1,0,7,-6,0,True,False
2022-11-13,10,Sun,1:00PM,Kansas City Chiefs,,Jacksonville Jaguars,27,17,486,3,315,0,0,10,171,3,True,False
2022-11-13,10,Sun,1:00PM,Pittsburgh Steelers,,New Orleans Saints,20,10,379,0,186,2,0,10,193,-2,True,False
2022-11-13,10,Sun,4:05PM,Indianapolis Colts,@,Las Vegas Raiders,25,20,415,1,309,0,0,5,106,1,False,True
2022-11-13,10,Sun,4:25PM,Green Bay Packers,,Dallas Cowboys,31,28,415,2,421,2,0,3,-6,0,True,False
2022-11-13,10,Sun,4:25PM,Arizona Cardinals,@,Los Angeles Rams,27,17,298,0,256,2,0,10,42,-2,False,True
2022-11-13,10,Sun,8:20PM,San Francisco 49ers,,Los Angeles Chargers,22,16,387,1,238,1,0,6,149,0,True,False
2022-11-13,10,Sun,1:00PM,Detroit Lions,@,Chicago Bears,31,30,323,0,408,1,0,1,-85,-1,False,True
2022-11-14,10,Mon,8:15PM,Washington Commanders,@,Philadelphia Eagles,32,21,330,2,264,4,0,11,66,-2,False,True
2022-11-17,11,Thu,8:15PM,Tennessee Titans,@,Green Bay Packers,27,17,408,1,271,0,0,10,137,1,False,True
2022-11-20,11,Sun,8:20PM,Kansas City Chiefs,@,Los Angeles Chargers,30,27,485,1,365,2,0,3,120,-1,False,True
2022-11-20,11,Sun,4:25PM,Dallas Cowboys,@,Minnesota Vikings,40,3,458,0,183,1,0,37,275,-1,False,True
2022-11-20,11,Sun,4:25PM,Cincinnati Bengals,@,Pittsburgh Steelers,37,30,408,2,351,0,0,7,57,2,False,True
2022-11-20,11,Sun,4:05PM,Las Vegas Raiders,@,Denver Broncos,22,16,407,0,320,0,0,6,87,0,False,True
2022-11-20,11,Sun,1:00PM,New Orleans Saints,,Los Angeles Rams,27,20,323,0,336,0,0,7,-13,0,True,False
2022-11-20,11,Sun,1:00PM,Atlanta Falcons,,Chicago Bears,27,24,280,2,288,1,0,3,-8,1,True,False
2022-11-20,11,Sun,1:00PM,Baltimore Ravens,,Carolina Panthers,13,3,308,1,205,3,0,10,103,-2,True,False
2022-11-20,11,Sun,1:00PM,New England Patriots,,New York Jets,10,3,297,0,103,0,0,7,194,0,True,False
2022-11-20,11,Sun,1:00PM,Washington Commanders,@,Houston Texans,23,10,344,0,148,2,0,13,196,-2,False,True
2022-11-20,11,Sun,1:00PM,Detroit Lions,@,New York Giants,31,18,325,0,413,3,0,13,-88,-3,False,True
2022-11-20,11,Sun,1:00PM,Buffalo Bills,,Cleveland Browns,31,23,357,0,396,1,0,8,-39,-1,True,False
2022-11-20,11,Sun,1:00PM,Philadelphia Eagles,@,Indianapolis Colts,17,16,314,2,284,1,0,1,30,1,False,True
2022-11-21,11,Mon,8:15PM,San Francisco 49ers,@,Arizona Cardinals,38,10,387,0,314,2,0,28,73,-2,False,True
2022-11-24,12,Thu,12:30PM,Buffalo Bills,@,Detroit Lions,28,25,401,1,326,2,0,3,75,-1,False,True
2022-11-24,12,Thu,4:30PM,Dallas Cowboys,,New York Giants,28,20,430,2,300,0,0,8,130,2,True,False
2022-11-24,12,Thu,8:20PM,Minnesota Vikings,,New England Patriots,33,26,358,1,409,0,0,7,-51,1,True,False
2022-11-27,12,Sun,8:20PM,Philadelphia Eagles,,Green Bay Packers,40,33,500,1,342,2,0,7,158,-1,True,False
2022-11-27,12,Sun,1:00PM,Cincinnati Bengals,@,Tennessee Titans,20,16,374,0,344,0,0,4,30,0,False,True
2022-11-27,12,Sun,4:25PM,San Francisco 49ers,,New Orleans Saints,13,0,317,0,260,2,0,13,57,-2,True,False
2022-11-27,12,Sun,4:05PM,Los Angeles Chargers,@,Arizona Cardinals,25,24,311,0,366,2,0,1,-55,-2,False,True
2022-11-27,12,Sun,4:05PM,Las Vegas Raiders,@,Seattle Seahawks,40,34,576,2,372,2,0,6,204,0,False,True
2022-11-27,12,Sun,1:00PM,New York Jets,,Chicago Bears,31,10,466,0,292,1,0,21,174,-1,True,False
2022-11-27,12,Sun,4:25PM,Kansas City Chiefs,,Los Angeles Rams,26,10,437,2,198,2,0,16,239,0,True,False
2022-11-27,12,Sun,1:00PM,Washington Commanders,,Atlanta Falcons,19,13,314,1,332,1,0,6,-18,0,True,False
2022-11-27,12,Sun,1:00PM,Jacksonville Jaguars,,Baltimore Ravens,28,27,332,1,415,2,0,1,-83,-1,True,False
2022-11-27,12,Sun,1:00PM,Miami Dolphins,,Houston Texans,30,15,339,1,210,3,0,15,129,-2,True,False
2022-11-27,12,Sun,1:00PM,Cleveland Browns,,Tampa Bay Buccaneers,23,17,367,1,325,0,0,6,42,1,True,False
2022-11-27,12,Sun,1:00PM,Carolina Panthers,,Denver Broncos,23,10,349,1,246,2,0,13,103,-1,True,False
2022-11-28,12,Mon,8:15PM,Pittsburgh Steelers,@,Indianapolis Colts,24,17,323,0,290,2,0,7,33,-2,False,True
2022-12-01,13,Thu,8:15PM,Buffalo Bills,@,New England Patriots,24,10,355,1,242,0,0,14,113,1,False,True
2022-12-04,13,Sun,4:05PM,San Francisco 49ers,,Miami Dolphins,33,17,351,1,308,4,0,16,43,-3,True,False
2022-12-04,13,Sun,8:20PM,Dallas Cowboys,,Indianapolis Colts,54,19,385,1,309,5,0,35,76,-4,True,False
2022-12-04,13,Sun,4:25PM,Las Vegas Raiders,,Los Angeles Chargers,27,20,404,2,386,1,0,7,18,1,True,False
2022-12-04,13,Sun,4:25PM,Cincinnati Bengals,,Kansas City Chiefs,27,24,431,0,349,1,0,3,82,-1,True,False
2022-12-04,13,Sun,4:05PM,Seattle Seahawks,@,Los Angeles Rams,27,23,438,2,319,2,0,4,119,0,False,True
2022-12-04,13,Sun,1:00PM,Pittsburgh Steelers,@,Atlanta Falcons,19,16,351,0,306,1,0,3,45,-1,False,True
2022-12-04,13,Sun,1:00PM,Green Bay Packers,@,Chicago Bears,28,19,357,0,409,3,0,9,-52,-3,False,True
2022-12-04,13,Sun,1:00PM,Washington Commanders,@,New York Giants,20,20,411,1,316,1,1,0,95,0,False,True
2022-12-04,13,Sun,1:00PM,Minnesota Vikings,,New York Jets,27,22,287,0,486,2,0,5,-199,-2,True,False
2022-12-04,13,Sun,1:00PM,Detroit Lions,,Jacksonville Jaguars,40,14,437,0,266,1,0,26,171,-1,True,False
2022-12-04,13,Sun,1:00PM,Baltimore Ravens,,Denver Broncos,10,9,285,2,272,0,0,1,13,2,True,False
2022-12-04,13,Sun,1:00PM,Cleveland Browns,@,Houston Texans,27,14,304,2,283,4,0,13,21,-2,False,True
2022-12-04,13,Sun,1:00PM,Philadelphia Eagles,,Tennessee Titans,35,10,453,0,209,0,0,25,244,0,True,False
2022-12-05,13,Mon,8:15PM,Tampa Bay Buccaneers,,New Orleans Saints,17,16,350,2,298,0,0,1,52,2,True,False
2022-12-08,14,Thu,8:15PM,Los Angeles Rams,,Las Vegas Raiders,17,16,282,1,302,2,0,1,-20,-1,True,False
2022-12-11,14,Sun,8:20PM,Los Angeles Chargers,,Miami Dolphins,23,17,432,0,219,0,0,6,213,0,True,False
2022-12-11,14,Sun,4:25PM,San Francisco 49ers,,Tampa Bay Buccaneers,35,7,404,1,322,3,0,28,82,-2,True,False
2022-12-11,14,Sun,4:25PM,Carolina Panthers,@,Seattle Seahawks,30,24,328,0,287,2,0,6,41,-2,False,True
2022-12-11,14,Sun,4:20PM,Kansas City Chiefs,@,Denver Broncos,34,28,431,3,320,2,0,6,111,1,False,True
2022-12-11,14,Sun,1:00PM,Baltimore Ravens,@,Pittsburgh Steelers,16,14,309,0,329,3,0,2,-20,-3,False,True
2022-12-11,14,Sun,1:00PM,Philadelphia Eagles,@,New York Giants,48,22,437,0,304,1,0,26,133,-1,False,True
2022-12-11,14,Sun,1:00PM,Dallas Cowboys,,Houston Texans,27,23,404,3,327,2,0,4,77,1,True,False
2022-12-11,14,Sun,1:00PM,Detroit Lions,,Minnesota Vikings,34,23,464,0,416,2,0,11,48,-2,True,False
2022-12-11,14,Sun,1:00PM,Cincinnati Bengals,,Cleveland Browns,23,10,363,1,344,1,0,13,19,0,True,False
2022-12-11,14,Sun,1:00PM,Buffalo Bills,,New York Jets,20,12,232,0,309,2,0,8,-77,-2,True,False
2022-12-11,14,Sun,1:00PM,Jacksonville Jaguars,@,Tennessee Titans,36,22,428,0,364,4,0,14,64,-4,False,True
2022-12-12,14,Mon,8:15PM,New England Patriots,@,Arizona Cardinals,27,13,328,1,323,2,0,14,5,-1,False,True
2022-12-15,15,Thu,8:15PM,San Francisco 49ers,@,Seattle Seahawks,21,13,381,0,277,1,0,8,104,-1,False,True
2022-12-17,15,Sat,8:15PM,Buffalo Bills,,Miami Dolphins,32,29,446,1,405,0,0,3,41,1,True,False
2022-12-17,15,Sat,4:30PM,Cleveland Browns,,Baltimore Ravens,13,3,283,0,324,2,0,10,-41,-2,True,False
2022-12-17,15,Sat,1:00PM,Minnesota Vikings,,Indianapolis Colts,39,36,518,3,341,1,0,3,177,2,True,False
2022-12-18,15,Sun,1:00PM,Detroit Lions,@,New York Jets,20,17,359,0,337,1,0,3,22,-1,False,True
2022-12-18,15,Sun,1:00PM,Pittsburgh Steelers,@,Carolina Panthers,24,16,325,0,209,0,0,8,116,0,False,True
2022-12-18,15,Sun,8:15PM,New York Giants,@,Washington Commanders,20,12,288,0,387,2,0,8,-99,-2,False,True
2022-12-18,15,Sun,4:25PM,Los Angeles Chargers,,Tennessee Titans,17,14,365,2,284,1,0,3,81,1,True,False
2022-12-18,15,Sun,4:25PM,Cincinnati Bengals,@,Tampa Bay Buccaneers,34,23,237,1,396,4,0,11,-159,-3,False,True
2022-12-18,15,Sun,4:05PM,Las Vegas Raiders,,New England Patriots,30,24,308,1,318,1,0,6,-10,0,True,False
2022-12-18,15,Sun,1:00PM,New Orleans Saints,,Atlanta Falcons,21,18,348,1,320,1,0,3,28,0,True,False
2022-12-18,15,Sun,1:00PM,Kansas City Chiefs,@,Houston Texans,30,24,502,2,219,1,0,6,283,1,False,True
2022-12-18,15,Sun,1:00PM,Jacksonville Jaguars,,Dallas Cowboys,40,34,503,3,397,2,0,6,106,1,True,False
2022-12-18,15,Sun,1:00PM,Philadelphia Eagles,@,Chicago Bears,25,20,421,3,248,1,0,5,173,2,False,True
2022-12-18,15,Sun,4:05PM,Denver Broncos,,Arizona Cardinals,24,15,324,2,240,3,0,9,84,-1,True,False
2022-12-19,15,Mon,8:15PM,Green Bay Packers,,Los Angeles Rams,24,12,345,2,156,1,0,12,189,1,True,False
2022-12-22,16,Thu,8:15PM,Jacksonville Jaguars,@,New York Jets,19,3,365,1,227,2,0,16,138,-1,False,True
2022-12-24,16,Sat,8:15PM,Pittsburgh Steelers,,Las Vegas Raiders,13,10,350,1,201,3,0,3,149,-2,True,False
2022-12-24,16,Sat,4:25PM,Dallas Cowboys,,Philadelphia Eagles,40,34,419,1,442,4,0,6,-23,-3,True,False
2022-12-24,16,Sat,1:00PM,Minnesota Vikings,,New York Giants,27,24,353,0,445,2,0,3,-92,-2,True,False
2022-12-24,16,Sat,1:00PM,Kansas City Chiefs,,Seattle Seahawks,24,10,297,0,333,1,0,14,-36,-1,True,False
2022-12-24,16,Sat,4:05PM,San Francisco 49ers,,Washington Commanders,37,20,371,1,349,2,0,17,22,-1,True,False
2022-12-24,16,Sat,1:00PM,New Orleans Saints,@,Cleveland Browns,17,10,244,1,249,1,0,7,-5,0,False,True
2022-12-24,16,Sat,1:00PM,Cincinnati Bengals,@,New England Patriots,22,18,442,3,285,1,0,4,157,2,False,True
2022-12-24,16,Sat,1:00PM,Carolina Panthers,,Detroit Lions,37,23,570,0,381,1,0,14,189,-1,True,False
2022-12-24,16,Sat,1:00PM,Buffalo Bills,@,Chicago Bears,35,13,426,3,209,2,0,22,217,1,False,True
2022-12-24,16,Sat,1:00PM,Baltimore Ravens,,Atlanta Falcons,17,9,299,0,327,1,0,8,-28,-1,True,False
2022-12-24,16,Sat,1:00PM,Houston Texans,@,Tennessee Titans,19,14,285,1,272,3,0,5,13,-2,False,True
2022-12-25,16,Sun,1:00PM,Green Bay Packers,@,Miami Dolphins,26,20,301,1,376,4,0,6,-75,-3,False,True
2022-12-25,16,Sun,4:30PM,Los Angeles Rams,,Denver Broncos,51,14,388,0,323,4,0,37,65,-4,True,False
2022-12-25,16,Sun,8:20PM,Tampa Bay Buccaneers,@,Arizona Cardinals,19,16,396,2,325,3,0,3,71,-1,False,True
2022-12-26,16,Mon,8:15PM,Los Angeles Chargers,@,Indianapolis Colts,20,3,314,2,173,3,0,17,141,-1,False,True
2022-12-29,17,Thu,8:15PM,Dallas Cowboys,@,Tennessee Titans,27,13,361,3,317,2,0,14,44,1,False,True
2023-01-01,17,Sun,4:05PM,Seattle Seahawks,,New York Jets,23,6,346,0,279,3,0,17,67,-3,True,False
2023-01-01,17,Sun,8:20PM,Pittsburgh Steelers,@,Baltimore Ravens,16,13,351,0,240,1,0,3,111,-1,False,True
2023-01-01,17,Sun,4:25PM,Los Angeles Chargers,,Los Angeles Rams,31,10,431,0,277,1,0,21,154,-1,True,False
2023-01-01,17,Sun,4:05PM,San Francisco 49ers,@,Las Vegas Raiders,37,34,454,1,500,2,0,3,-46,-1,False,True
2023-01-01,17,Sun,1:00PM,New England Patriots,,Miami Dolphins,23,21,249,0,333,2,0,2,-84,-2,True,False
2023-01-01,17,Sun,4:25PM,Green Bay Packers,,Minnesota Vikings,41,17,315,0,346,4,0,24,-31,-4,True,False
2023-01-01,17,Sun,1:00PM,Kansas City Chiefs,,Denver Broncos,27,24,374,2,307,2,0,3,67,0,True,False
2023-01-01,17,Sun,1:00PM,Jacksonville Jaguars,@,Houston Texans,31,3,337,2,277,1,0,28,60,1,False,True
2023-01-01,17,Sun,1:00PM,Atlanta Falcons,,Arizona Cardinals,20,19,298,1,339,0,0,1,-41,1,True,False
2023-01-01,17,Sun,1:00PM,Tampa Bay Buccaneers,,Carolina Panthers,30,24,478,1,400,3,0,6,78,-2,True,False
2023-01-01,17,Sun,1:00PM,New Orleans Saints,@,Philadelphia Eagles,20,10,313,1,313,1,0,10,0,0,False,True
2023-01-01,17,Sun,1:00PM,Cleveland Browns,@,Washington Commanders,24,10,301,0,260,3,0,14,41,-3,False,True
2023-01-01,17,Sun,1:00PM,New York Giants,,Indianapolis Colts,38,10,394,1,252,1,0,28,142,0,True,False
2023-01-01,17,Sun,1:00PM,Detroit Lions,,Chicago Bears,41,10,504,0,230,2,0,31,274,-2,True,False
2023-01-07,18,Sat,4:30PM,Kansas City Chiefs,@,Las Vegas Raiders,31,13,349,0,279,2,0,18,70,-2,False,True
2023-01-07,18,Sat,8:15PM,Jacksonville Jaguars,,Tennessee Titans,20,16,222,1,312,2,0,4,-90,-1,True,False
2023-01-08,18,Sun,8:20PM,Detroit Lions,@,Green Bay Packers,20,16,323,0,291,2,0,4,32,-2,False,True
2023-01-08,18,Sun,4:25PM,Seattle Seahawks,,Los Angeles Rams,19,16,402,2,269,1,0,3,133,1,True,False
2023-01-08,18,Sun,4:25PM,Denver Broncos,,Los Angeles Chargers,31,28,471,2,352,2,0,3,119,0,True,False
2023-01-08,18,Sun,4:25PM,San Francisco 49ers,,Arizona Cardinals,38,13,311,0,255,4,0,25,56,-4,True,False
2023-01-08,18,Sun,1:00PM,Miami Dolphins,,New York Jets,11,6,302,0,187,0,0,5,115,0,True,False
2023-01-08,18,Sun,4:25PM,Philadelphia Eagles,,New York Giants,22,16,342,1,284,0,0,6,58,1,True,False
2023-01-08,18,Sun,1:00PM,Pittsburgh Steelers,,Cleveland Browns,28,14,333,1,307,2,0,14,26,-1,True,False
2023-01-08,18,Sun,1:00PM,Houston Texans,@,Indianapolis Colts,32,31,360,3,398,3,0,1,-38,0,False,True
2023-01-08,18,Sun,1:00PM,Buffalo Bills,,New England Patriots,35,23,327,3,341,3,0,12,-14,0,True,False
2023-01-08,18,Sun,1:00PM,Cincinnati Bengals,,Baltimore Ravens,27,16,257,1,386,4,0,11,-129,-3,True,False
2023-01-08,18,Sun,4:25PM,Washington Commanders,,Dallas Cowboys,26,6,309,1,182,2,0,20,127,-1,True,False
2023-01-08,18,Sun,1:00PM,Carolina Panthers,@,New Orleans Saints,10,7,203,2,304,1,0,3,-101,1,False,True
2023-01-08,18,Sun,1:00PM,Minnesota Vikings,@,Chicago Bears,29,13,482,2,259,2,0,16,223,0,False,True
2023-01-08,18,Sun,1:00PM,Atlanta Falcons,,Tampa Bay Buccaneers,30,17,382,1,222,1,0,13,160,0,True,False
2023-01-14,WildCard,Sat,4:30PM,San Francisco 49ers,,Seattle Seahawks,41,23,505,0,332,2,0,18,173,-2,True,False
2023-01-14,WildCard,Sat,8:15PM,Jacksonville Jaguars,,Los Angeles Chargers,31,30,390,5,320,0,0,1,70,5,True,False
2023-01-15,WildCard,Sun,1:00PM,Buffalo Bills,,Miami Dolphins,34,31,423,3,231,2,0,3,192,1,True,False
2023-01-15,WildCard,Sun,8:15PM,Cincinnati Bengals,,Baltimore Ravens,24,17,234,1,364,2,0,7,-130,-1,True,False
2023-01-15,WildCard,Sun,4:30PM,New York Giants,@,Minnesota Vikings,31,24,431,0,332,0,0,7,99,0,False,True
2023-01-16,WildCard,Mon,8:15PM,Dallas Cowboys,@,Tampa Bay Buccaneers,31,14,425,0,386,1,0,17,39,-1,False,True
2023-01-21,Division,Sat,4:30PM,Kansas City Chiefs,,Jacksonville Jaguars,27,20,362,0,349,2,0,7,13,-2,True,False
2023-01-21,Division,Sat,8:15PM,Philadelphia Eagles,,New York Giants,38,7,416,0,227,1,0,31,189,-1,True,False
2023-01-22,Division,Sun,3:00PM,Cincinnati Bengals,@,Buffalo Bills,27,10,412,0,325,1,0,17,87,-1,False,True
2023-01-22,Division,Sun,6:30PM,San Francisco 49ers,,Dallas Cowboys,19,12,312,1,282,2,0,7,30,-1,True,False
2023-01-29,ConfChamp,Sun,3:00PM,Philadelphia Eagles,,San Francisco 49ers,31,7,269,0,164,3,0,24,105,-3,True,False
2023-01-29,ConfChamp,Sun,6:30PM,Kansas City Chiefs,,Cincinnati Bengals,23,20,357,1,309,2,0,3,48,-1,True,False
2023-02-12,SuperBowl,Sun,6:30PM,Kansas City Chiefs,N,Philadelphia Eagles,38,35,340,0,417,1,0,3,-77,-1,False,False
2023-09-07,1,Thu,8:20PM,Detroit Lions,@,Kansas City Chiefs,21,20,368,1,316,1,0,1,52,0,False,True
2023-09-10,1,Sun,4:25PM,Miami Dolphins,@,Los Angeles Chargers,36,34,536,2,433,0,0,2,103,2,False,True
2023-09-10,1,Sun,8:20PM,Dallas Cowboys,@,New York Giants,40,0,265,0,171,3,0,40,94,-3,False,True
2023-09-10,1,Sun,4:25PM,Los Angeles Rams,@,Seattle Seahawks,30,13,426,0,180,0,0,17,246,0,False,True
2023-09-10,1,Sun,4:25PM,Philadelphia Eagles,@,New England Patriots,25,20,251,1,382,2,0,5,-131,-1,False,True
2023-09-10,1,Sun,4:25PM,Las Vegas Raiders,@,Denver Broncos,17,16,261,1,260,0,0,1,1,1,False,True
2023-09-10,1,Sun,4:25PM,Green Bay Packers,@,Chicago Bears,38,20,329,0,311,2,0,18,18,-2,False,True
2023-09-10,1,Sun,1:00PM,New Orleans Saints,,Tennessee Titans,16,15,351,2,285,3,0,1,66,-1,True,False
2023-09-10,1,Sun,1:00PM,San Francisco 49ers,@,Pittsburgh Steelers,30,7,391,1,239,2,0,23,152,-1,False,True
2023-09-10,1,Sun,1:00PM,Baltimore Ravens,,Houston Texans,25,9,265,2,268,1,0,16,-3,1,True,False
2023-09-10,1,Sun,1:00PM,Washington Commanders,,Arizona Cardinals,20,16,248,3,210,2,0,4,38,1,True,False
2023-09-10,1,Sun,1:00PM,Jacksonville Jaguars,@,Indianapolis Colts,31,21,342,2,280,3,0,10,62,-1,False,True
2023-09-10,1,Sun,1:00PM,Cleveland Browns,,Cincinnati Bengals,24,3,350,2,142,0,0,21,208,2,True,False
2023-09-10,1,Sun,1:00PM,Atlanta Falcons,,Carolina Panthers,24,10,221,0,281,3,0,14,-60,-3,True,False
2023-09-10,1,Sun,1:00PM,Tampa Bay Buccaneers,@,Minnesota Vikings,20,17,242,0,369,3,0,3,-127,-3,False,True
2023-09-11,1,Mon,8:15PM,New York Jets,,Buffalo Bills,22,16,289,1,314,4,0,6,-25,-3,True,False
2023-09-14,2,Thu,8:15PM,Philadelphia Eagles,,Minnesota Vikings,34,28,430,1,374,4,0,6,56,-3,True,False
2023-09-17,2,Sun,4:05PM,New York Giants,@,Arizona Cardinals,31,28,439,1,379,0,0,3,60,1,False,True
2023-09-17,2,Sun,4:05PM,San Francisco 49ers,@,Los Angeles Rams,30,23,365,0,386,2,0,7,-21,-2,False,True
2023-09-17,2,Sun,4:25PM,Dallas Cowboys,,New York Jets,30,10,382,0,215,4,0,20,167,-4,True,False
2023-09-17,2,Sun,8:20PM,Miami Dolphins,@,New England Patriots,24,17,389,1,288,2,0,7,101,-1,False,True
2023-09-17,2,Sun,1:00PM,Tennessee Titans,,Los Angeles Chargers,27,24,341,0,342,0,0,3,-1,0,True,False
2023-09-17,2,Sun,4:25PM,Washington Commanders,@,Denver Broncos,35,33,388,0,399,2,0,2,-11,-2,False,True
2023-09-17,2,Sun,1:00PM,Kansas City Chiefs,@,Jacksonville Jaguars,17,9,399,3,271,1,0,8,128,2,False,True
2023-09-17,2,Sun,1:00PM,Buffalo Bills,,Las Vegas Raiders,38,10,450,0,240,3,0,28,210,-3,True,False
2023-09-17,2,Sun,1:00PM,Indianapolis Colts,@,Houston Texans,31,20,353,0,389,1,0,11,-36,-1,False,True
2023-09-17,2,Sun,1:00PM,Baltimore Ravens,@,Cincinnati Bengals,27,24,415,0,282,1,0,3,133,-1,False,True
2023-09-17,2,Sun,1:00PM,Tampa Bay Buccaneers,,Chicago Bears,27,17,437,0,236,2,0,10,201,-2,True,False
2023-09-17,2,Sun,1:00PM,Atlanta Falcons,,Green Bay Packers,25,24,446,1,224,0,0,1,222,1,True,False
2023-09-17,2,Sun,1:00PM,Seattle Seahawks,@,Detroit Lions,37,31,393,0,418,3,0,6,-25,-3,False,True
2023-09-18,2,Mon,7:15PM,New Orleans Saints,@,Carolina Panthers,20,17,341,1,239,1,0,3,102,0,False,True
2023-09-18,2,Mon,8:15PM,Pittsburgh Steelers,,Cleveland Browns,26,22,255,2,408,4,0,4,-153,-2,True,False
2023-09-21,3,Thu,8:15PM,San Francisco 49ers,,New York Giants,30,12,441,0,150,1,0,18,291,-1,True,False
2023-09-24,3,Sun,8:20PM,Pittsburgh Steelers,@,Las Vegas Raiders,23,18,333,0,362,3,0,5,-29,-3,False,True
2023-09-24,3,Sun,1:00PM,Los Angeles Chargers,@,Minnesota Vikings,28,24,475,1,475,2,0,4,0,-1,False,True
2023-09-24,3,Sun,4:25PM,Arizona Cardinals,,Dallas Cowboys,28,16,400,0,416,1,0,12,-16,-1,True,False
2023-09-24,3,Sun,4:25PM,Kansas City Chiefs,,Chicago Bears,41,10,456,2,203,2,0,31,253,0,True,False
2023-09-24,3,Sun,1:00PM,New England Patriots,@,New York Jets,15,10,358,0,171,0,0,5,187,0,False,True
2023-09-24,3,Sun,1:00PM,Houston Texans,@,Jacksonville Jaguars,37,17,366,0,404,2,0,20,-38,-2,False,True
2023-09-24,3,Sun,4:05PM,Seattle Seahawks,,Carolina Panthers,37,27,425,1,378,0,0,10,47,1,True,False
2023-09-24,3,Sun,1:00PM,Miami Dolphins,,Denver Broncos,70,20,726,0,363,3,0,50,363,-3,True,False
2023-09-24,3,Sun,1:00PM,Indianapolis Colts,@,Baltimore Ravens,22,19,327,0,364,2,0,3,-37,-2,False,True
2023-09-24,3,Sun,1:00PM,Cleveland Browns,,Tennessee Titans,27,3,341,1,94,0,0,24,247,1,True,False
2023-09-24,3,Sun,1:00PM,Buffalo Bills,@,Washington Commanders,37,3,386,1,230,5,0,34,156,-4,False,True
2023-09-24,3,Sun,1:00PM,Detroit Lions,,Atlanta Falcons,20,6,358,1,183,1,0,14,175,0,True,False
2023-09-24,3,Sun,1:00PM,Green Bay Packers,,New Orleans Saints,18,17,340,1,252,0,0,1,88,1,True,False
2023-09-25,3,Mon,7:15PM,Philadelphia Eagles,@,Tampa Bay Buccaneers,25,11,472,2,174,2,0,14,298,0,False,True
2023-09-25,3,Mon,8:15PM,Cincinnati Bengals,,Los Angeles Rams,19,16,309,1,292,2,0,3,17,-1,True,False
2023-09-28,4,Thu,8:15PM,Detroit Lions,@,Green Bay Packers,34,20,401,1,230,2,0,14,171,-1,False,True
2023-10-01,4,Sun,8:20PM,Kansas City Chiefs,@,New York Jets,23,20,401,2,336,1,0,3,65,1,False,True
2023-10-01,4,Sun,1:00PM,Tampa Bay Buccaneers,@,New Orleans Saints,26,9,353,1,197,3,0,17,156,-2,False,True
2023-10-01,4,Sun,4:25PM,Dallas Cowboys,,New England Patriots,38,3,377,0,253,3,0,35,124,-3,True,False
2023-10-01,4,Sun,4:25PM,San Francisco 49ers,,Arizona Cardinals,35,16,395,0,362,0,0,19,33,0,True,False
2023-10-01,4,Sun,4:05PM,Los Angeles Chargers,,Las Vegas Raiders,24,17,305,1,264,3,0,7,41,-2,True,False
2023-10-01,4,Sun,1:00PM,Philadelphia Eagles,,Washington Commanders,34,31,415,0,365,0,0,3,50,0,True,False
2023-10-01,4,Sun,1:00PM,Houston Texans,,Pittsburgh Steelers,30,6,451,0,225,1,0,24,226,-1,True,False
2023-10-01,4,Sun,1:00PM,Los Angeles Rams,@,Indianapolis Colts,29,23,467,1,329,1,0,6,138,0,False,True
2023-10-01,4,Sun,1:00PM,Baltimore Ravens,@,Cleveland Browns,28,3,296,1,166,3,0,25,130,-2,False,True
2023-10-01,4,Sun,1:00PM,Tennessee Titans,,Cincinnati Bengals,27,3,400,1,211,1,0,24,189,0,True,False
2023-10-01,4,Sun,1:00PM,Denver Broncos,@,Chicago Bears,31,28,311,0,471,2,0,3,-160,-2,False,True
2023-10-01,4,Sun,1:00PM,Minnesota Vikings,@,Carolina Panthers,21,13,265,2,232,1,0,8,33,1,False,True
2023-10-01,4,Sun,1:00PM,Buffalo Bills,,Miami Dolphins,48,20,414,0,393,2,0,28,21,-2,True,False
2023-10-01,4,Sun,9:30AM,Jacksonville Jaguars,,Atlanta Falcons,23,7,300,0,287,3,0,16,13,-3,True,False
2023-10-02,4,Mon,8:15PM,Seattle Seahawks,@,New York Giants,24,3,281,0,248,3,0,21,33,-3,False,True
2023-10-05,5,Thu,8:15PM,Chicago Bears,@,Washington Commanders,40,20,451,0,388,2,0,20,63,-2,False,True
2023-10-08,5,Sun,8:20PM,San Francisco 49ers,,Dallas Cowboys,42,10,421,1,197,4,0,32,224,-3,True,False
2023-10-08,5,Sun,4:25PM,Kansas City Chiefs,@,Minnesota Vikings,27,20,333,0,329,1,0,7,4,-1,False,True
2023-10-08,5,Sun,4:25PM,New York Jets,@,Denver Broncos,31,21,407,2,308,3,0,10,99,-1,False,True
2023-10-08,5,Sun,4:05PM,Philadelphia Eagles,@,Los Angeles Rams,23,14,454,1,249,0,0,9,205,1,False,True
2023-10-08,5,Sun,4:05PM,Cincinnati Bengals,@,Arizona Cardinals,34,20,380,1,294,3,0,14,86,-2,False,True
2023-10-08,5,Sun,1:00PM,Pittsburgh Steelers,,Baltimore Ravens,17,10,289,1,335,3,0,7,-46,-2,True,False
2023-10-08,5,Sun,1:00PM,New Orleans Saints,@,New England Patriots,34,0,304,0,156,3,0,34,148,-3,False,True
2023-10-08,5,Sun,1:00PM,Miami Dolphins,,New York Giants,31,16,524,3,268,0,0,15,256,3,True,False
2023-10-08,5,Sun,1:00PM,Indianapolis Colts,,Tennessee Titans,23,16,429,0,348,1,0,7,81,-1,True,False
2023-10-08,5,Sun,1:00PM,Detroit Lions,,Carolina Panthers,42,24,377,0,342,3,0,18,35,-3,True,False
2023-10-08,5,Sun,1:00PM,Atlanta Falcons,,Houston Texans,21,19,447,2,313,0,0,2,134,2,True,False
2023-10-08,5,Sun,9:30AM,Jacksonville Jaguars,@,Buffalo Bills,25,20,474,2,388,2,0,5,86,0,False,True
2023-10-09,5,Mon,8:15PM,Las Vegas Raiders,,Green Bay Packers,17,13,279,1,285,3,0,4,-6,-2,True,False
2023-10-12,6,Thu,8:15PM,Kansas City Chiefs,,Denver Broncos,19,8,389,1,197,3,0,11,192,-2,True,False
2023-10-15,6,Sun,1:00PM,Houston Texans,,New Orleans Saints,20,13,297,1,430,2,0,7,-133,-1,True,False
2023-10-15,6,Sun,4:25PM,New York Jets,,Philadelphia Eagles,20,14,244,0,348,4,0,6,-104,-4,True,False
2023-10-15,6,Sun,4:25PM,Detroit Lions,@,Tampa Bay Buccaneers,20,6,380,0,251,1,0,14,129,-1,False,True
2023-10-15,6,Sun,4:25PM,Los Angeles Rams,,Arizona Cardinals,26,9,382,1,345,2,0,17,37,-1,True,False
2023-10-15,6,Sun,4:05PM,Las Vegas Raiders,,New England Patriots,21,17,348,1,259,1,0,4,89,0,True,False
2023-10-15,6,Sun,8:20PM,Buffalo Bills,,New York Giants,14,9,297,2,317,0,0,5,-20,2,True,False
2023-10-15,6,Sun,1:00PM,Jacksonville Jaguars,,Indianapolis Colts,37,20,233,1,354,4,0,17,-121,-3,True,False
2023-10-15,6,Sun,1:00PM,Minnesota Vikings,@,Chicago Bears,19,13,220,1,275,3,0,6,-55,-2,False,True
2023-10-15,6,Sun,1:00PM,Miami Dolphins,,Carolina Panthers,42,21,424,1,296,0,0,21,128,1,True,False
2023-10-15,6,Sun,1:00PM,Washington Commanders,@,Atlanta Falcons,24,16,193,0,402,3,0,8,-209,-3,False,True
2023-10-15,6,Sun,1:00PM,Cleveland Browns,,San Francisco 49ers,19,17,334,2,215,1,0,2,119,1,True,False
2023-10-15,6,Sun,9:30AM,Baltimore Ravens,@,Tennessee Titans,24,16,360,1,233,2,0,8,127,-1,False,True
2023-10-15,6,Sun,1:00PM,Cincinnati Bengals,,Seattle Seahawks,17,13,214,1,384,2,0,4,-170,-1,True,False
2023-10-16,6,Mon,8:15PM,Dallas Cowboys,@,Los Angeles Chargers,20,17,342,1,272,1,0,3,70,0,False,True
2023-10-19,7,Thu,8:15PM,Jacksonville Jaguars,@,New Orleans Saints,31,24,330,2,407,1,0,7,-77,1,False,True
2023-10-22,7,Sun,1:00PM,Baltimore Ravens,,Detroit Lions,38,6,503,1,337,1,0,32,166,0,True,False
2023-10-22,7,Sun,8:20PM,Philadelphia Eagles,,Miami Dolphins,31,17,355,2,244,1,0,14,111,1,True,False
2023-10-22,7,Sun,4:25PM,Kansas City Chiefs,,Los Angeles Chargers,31,17,483,2,358,2,0,14,125,0,True,False
2023-10-22,7,Sun,4:25PM,Denver Broncos,,Green Bay Packers,19,17,339,0,331,1,0,2,8,-1,True,False
2023-10-22,7,Sun,4:05PM,Seattle Seahawks,,Arizona Cardinals,20,10,318,3,249,0,0,10,69,3,True,False
2023-10-22,7,Sun,4:05PM,Pittsburgh Steelers,@,Los Angeles Rams,24,17,300,0,354,1,0,7,-54,-1,False,True
2023-10-22,7,Sun,1:00PM,New England Patriots,,Buffalo Bills,29,25,364,1,339,2,0,4,25,-1,True,False
2023-10-22,7,Sun,1:00PM,Chicago Bears,,Las Vegas Raiders,30,12,323,0,235,3,0,18,88,-3,True,False
2023-10-22,7,Sun,1:00PM,Atlanta Falcons,@,Tampa Bay Buccaneers,16,13,401,3,329,2,0,3,72,1,False,True
2023-10-22,7,Sun,1:00PM,Cleveland Browns,@,Indianapolis Colts,39,38,316,2,456,4,0,1,-140,-2,False,True
2023-10-22,7,Sun,1:00PM,New York Giants,,Washington Commanders,14,7,356,2,273,1,0,7,83,1,True,False
2023-10-23,7,Mon,8:15PM,Minnesota Vikings,,San Francisco 49ers,22,17,452,1,325,3,0,5,127,-2,True,False
2023-10-26,8,Thu,8:15PM,Buffalo Bills,,Tampa Bay Buccaneers,24,18,427,1,302,0,0,6,125,1,True,False
2023-10-29,8,Sun,1:00PM,Philadelphia Eagles,@,Washington Commanders,38,31,374,2,472,1,0,7,-98,1,False,True
2023-10-29,8,Sun,8:20PM,Los Angeles Chargers,,Chicago Bears,30,13,352,1,295,2,0,17,57,-1,True,False
2023-10-29,8,Sun,4:25PM,Baltimore Ravens,@,Arizona Cardinals,31,24,268,0,310,2,0,7,-42,-2,False,True
2023-10-29,8,Sun,1:00PM,New York Jets,@,New York Giants,13,10,251,2,194,0,0,3,57,2,False,True
2023-10-29,8,Sun,4:25PM,Denver Broncos,,Kansas City Chiefs,24,9,240,1,274,5,0,15,-34,-4,True,False
2023-10-29,8,Sun,1:00PM,Miami Dolphins,,New England Patriots,31,17,390,2,218,1,0,14,172,1,True,False
2023-10-29,8,Sun,4:05PM,Seattle Seahawks,,Cleveland Browns,24,20,362,2,385,3,0,4,-23,-1,True,False
2023-10-29,8,Sun,1:00PM,New Orleans Saints,@,Indianapolis Colts,38,27,511,1,371,1,0,11,140,0,False,True
2023-10-29,8,Sun,1:00PM,Minnesota Vikings,@,Green Bay Packers,24,10,346,1,270,1,0,14,76,0,False,True
2023-10-29,8,Sun,1:00PM,Dallas Cowboys,,Los Angeles Rams,43,20,387,1,280,1,0,23,107,0,True,False
2023-10-29,8,Sun,1:00PM,Jacksonville Jaguars,@,Pittsburgh Steelers,20,10,377,3,261,2,0,10,116,1,False,True
2023-10-29,8,Sun,4:25PM,Cincinnati Bengals,@,San Francisco 49ers,31,17,400,1,460,3,0,14,-60,-2,False,True
2023-10-29,8,Sun,1:00PM,Carolina Panthers,,Houston Texans,15,13,224,0,229,1,0,2,-5,-1,True,False
2023-10-29,8,Sun,1:00PM,Tennessee Titans,,Atlanta Falcons,28,23,375,1,342,1,0,5,33,0,True,False
2023-10-30,8,Mon,8:15PM,Detroit Lions,,Las Vegas Raiders,26,14,486,3,157,1,0,12,329,2,True,False
2023-11-02,9,Thu,8:15PM,Pittsburgh Steelers,,Tennessee Titans,20,16,326,0,340,1,0,4,-14,-1,True,False
2023-11-05,9,Sun,8:20PM,Cincinnati Bengals,,Buffalo Bills,24,18,397,0,317,2,0,6,80,-2,True,False
2023-11-05,9,Sun,4:25PM,Las Vegas Raiders,,New York Giants,30,6,334,0,277,2,0,24,57,-2,True,False
2023-11-05,9,Sun,4:25PM,Philadelphia Eagles,,Dallas Cowboys,28,23,292,0,406,1,0,5,-114,-1,True,False
2023-11-05,9,Sun,1:00PM,Baltimore Ravens,,Seattle Seahawks,37,3,515,2,151,2,0,34,364,0,True,False
2023-11-05,9,Sun,4:05PM,Indianapolis Colts,@,Carolina Panthers,27,13,198,1,275,3,0,14,-77,-2,False,True
2023-11-05,9,Sun,1:00PM,Minnesota Vikings,@,Atlanta Falcons,31,28,363,2,370,2,0,3,-7,0,False,True
2023-11-05,9,Sun,1:00PM,Houston Texans,,Tampa Bay Buccaneers,39,37,496,1,332,1,0,2,164,0,True,False
2023-11-05,9,Sun,1:00PM,Green Bay Packers,,Los Angeles Rams,20,3,391,2,187,2,0,17,204,0,True,False
2023-11-05,9,Sun,1:00PM,Cleveland Browns,,Arizona Cardinals,27,0,326,0,58,3,0,27,268,-3,True,False
2023-11-05,9,Sun,9:30AM,Kansas City Chiefs,,Miami Dolphins,21,14,267,1,292,1,0,7,-25,0,True,False
2023-11-05,9,Sun,1:00PM,New Orleans Saints,,Chicago Bears,24,17,301,0,368,5,0,7,-67,-5,True,False
2023-11-05,9,Sun,1:00PM,Washington Commanders,@,New England Patriots,20,17,432,2,327,1,0,3,105,1,False,True
2023-11-06,9,Mon,8:15PM,Los Angeles Chargers,@,New York Jets,27,6,191,0,270,3,0,21,-79,-3,False,True
2023-11-09,10,Thu,8:15PM,Chicago Bears,,Carolina Panthers,16,13,295,0,213,0,0,3,82,0,True,False
2023-11-12,10,Sun,9:30AM,Indianapolis Colts,@,New England Patriots,10,6,264,1,340,2,0,4,-76,-1,False,True
2023-11-12,10,Sun,1:00PM,Houston Texans,@,Cincinnati Bengals,30,27,544,3,380,2,0,3,164,1,False,True
2023-11-12,10,Sun,1:00PM,Cleveland Browns,@,Baltimore Ravens,33,31,373,2,306,2,0,2,67,0,False,True
2023-11-12,10,Sun,1:00PM,Pittsburgh Steelers,,Green Bay Packers,23,19,324,0,399,2,0,4,-75,-2,True,False
2023-11-12,10,Sun,1:00PM,Minnesota Vikings,,New Orleans Saints,27,19,388,0,280,2,0,8,108,-2,True,False
2023-11-12,10,Sun,4:05PM,Detroit Lions,@,Los Angeles Chargers,41,38,533,0,421,1,0,3,112,-1,False,True
2023-11-12,10,Sun,1:00PM,Tampa Bay Buccaneers,,Tennessee Titans,20,6,340,1,209,1,0,14,131,0,True,False
2023-11-12,10,Sun,8:20PM,Las Vegas Raiders,,New York Jets,16,12,274,2,365,1,0,4,-91,1,True,False
2023-11-12,10,Sun,1:00PM,San Francisco 49ers,@,Jacksonville Jaguars,34,3,437,0,221,4,0,31,216,-4,False,True
2023-11-12,10,Sun,4:25PM,Dallas Cowboys,,New York Giants,49,17,640,2,172,1,0,32,468,1,True,False
2023-11-12,10,Sun,4:25PM,Seattle Seahawks,,Washington Commanders,29,26,489,0,356,1,0,3,133,-1,True,False
2023-11-12,10,Sun,4:05PM,Arizona Cardinals,,Atlanta Falcons,25,23,352,1,254,0,0,2,98,1,True,False
2023-11-13,10,Mon,8:15PM,Denver Broncos,@,Buffalo Bills,24,22,300,1,369,4,0,2,-69,-3,False,True
2023-11-16,11,Thu,8:15PM,Baltimore Ravens,,Cincinnati Bengals,34,20,405,0,272,0,0,14,133,0,True,False
2023-11-19,11,Sun,8:20PM,Denver Broncos,,Minnesota Vikings,21,20,295,0,385,3,0,1,-90,-3,True,False
2023-11-19,11,Sun,4:25PM,Buffalo Bills,,New York Jets,32,6,393,1,155,4,0,26,238,-3,True,False
2023-11-19,11,Sun,4:25PM,Los Angeles Rams,,Seattle Seahawks,17,16,267,1,291,1,0,1,-24,0,True,False
2023-11-19,11,Sun,4:05PM,San Francisco 49ers,,Tampa Bay Buccaneers,27,14,420,0,287,2,0,13,133,-2,True,False
2023-11-19,11,Sun,1:00PM,New York Giants,@,Washington Commanders,31,19,292,0,404,6,0,12,-112,-6,False,True
2023-11-19,11,Sun,1:00PM,Miami Dolphins,,Las Vegas Raiders,20,13,422,3,296,3,0,7,126,0,True,False
2023-11-19,11,Sun,1:00PM,Jacksonville Jaguars,,Tennessee Titans,34,14,389,0,235,2,0,20,154,-2,True,False
2023-11-19,11,Sun,1:00PM,Green Bay Packers,,Los Angeles Chargers,23,20,397,0,394,1,0,3,3,-1,True,False
2023-11-19,11,Sun,1:00PM,Cleveland Browns,,Pittsburgh Steelers,13,10,259,1,249,0,0,3,10,1,True,False
2023-11-19,11,Sun,1:00PM,Dallas Cowboys,@,Carolina Panthers,33,10,311,0,187,2,0,23,124,-2,False,True
2023-11-19,11,Sun,1:00PM,Houston Texans,,Arizona Cardinals,21,16,419,3,319,2,0,5,100,1,True,False
2023-11-19,11,Sun,1:00PM,Detroit Lions,,Chicago Bears,31,26,338,4,334,1,0,5,4,3,True,False
2023-11-20,11,Mon,8:15PM,Philadelphia Eagles,@,Kansas City Chiefs,21,17,238,1,336,2,0,4,-98,-1,False,True
2023-11-23,12,Thu,12:30PM,Green Bay Packers,@,Detroit Lions,29,22,377,0,464,3,0,7,-87,-3,False,True
2023-11-23,12,Thu,4:30PM,Dallas Cowboys,,Washington Commanders,45,10,431,0,376,1,0,35,55,-1,True,False
2023-11-23,12,Thu,8:20PM,San Francisco 49ers,@,Seattle Seahawks,31,13,377,1,220,2,0,18,157,-1,False,True
2023-11-24,12,Fri,3:00PM,Miami Dolphins,@,New York Jets,34,13,395,3,159,2,0,21,236,1,False,True
2023-11-26,12,Sun,4:25PM,Philadelphia Eagles,,Buffalo Bills,37,34,378,2,505,1,0,3,-127,1,True,False
2023-11-26,12,Sun,1:00PM,Atlanta Falcons,,New Orleans Saints,24,15,396,2,444,2,0,9,-48,0,True,False
2023-11-26,12,Sun,8:20PM,Baltimore Ravens,@,Los Angeles Chargers,20,10,361,0,279,4,0,10,82,-4,False,True
2023-11-26,12,Sun,4:05PM,Los Angeles Rams,@,Arizona Cardinals,37,14,457,1,292,0,0,23,165,1,False,True
2023-11-26,12,Sun,4:05PM,Denver Broncos,,Cleveland Browns,29,12,294,1,269,3,0,17,25,-2,True,False
2023-11-26,12,Sun,1:00PM,New York Giants,,New England Patriots,10,7,220,1,283,3,0,3,-63,-2,True,False
2023-11-26,12,Sun,4:25PM,Kansas City Chiefs,@,Las Vegas Raiders,31,17,360,0,358,0,0,14,2,0,False,True
2023-11-26,12,Sun,1:00PM,Indianapolis Colts,,Tampa Bay Buccaneers,27,20,394,1,298,2,0,7,96,-1,True,False
2023-11-26,12,Sun,1:00PM,Pittsburgh Steelers,@,Cincinnati Bengals,16,10,421,1,222,1,0,6,199,0,False,True
2023-11-26,12,Sun,1:00PM,Tennessee Titans,,Carolina Panthers,17,10,264,0,258,1,0,7,6,-1,True,False
2023-11-26,12,Sun,1:00PM,Jacksonville Jaguars,@,Houston Texans,24,21,445,1,352,0,0,3,93,1,False,True
2023-11-27,12,Mon,8:15PM,Chicago Bears,@,Minnesota Vikings,12,10,317,2,242,4,0,2,75,-2,False,True
2023-11-30,13,Thu,8:15PM,Dallas Cowboys,,Seattle Seahawks,41,35,411,0,406,1,0,6,5,-1,True,False
2023-12-03,13,Sun,1:00PM,Arizona Cardinals,@,Pittsburgh Steelers,24,10,282,0,317,1,0,14,-35,-1,False,True
2023-12-03,13,Sun,8:20PM,Green Bay Packers,,Kansas City Chiefs,27,19,382,0,337,1,0,8,45,-1,True,False
2023-12-03,13,Sun,4:25PM,San Francisco 49ers,@,Philadelphia Eagles,42,19,456,0,333,0,0,23,123,0,False,True
2023-12-03,13,Sun,4:25PM,Los Angeles Rams,,Cleveland Browns,36,19,399,0,327,1,0,17,72,-1,True,False
2023-12-03,13,Sun,4:05PM,Tampa Bay Buccaneers,,Carolina Panthers,21,18,322,1,282,1,0,3,40,0,True,False
2023-12-03,13,Sun,1:00PM,Los Angeles Chargers,@,New England Patriots,6,0,241,0,257,1,0,6,-16,-1,False,True
2023-12-03,13,Sun,1:00PM,Houston Texans,,Denver Broncos,22,17,353,0,282,3,0,5,71,-3,True,False
2023-12-03,13,Sun,1:00PM,Detroit Lions,@,New Orleans Saints,33,28,347,0,362,2,0,5,-15,-2,False,True
2023-12-03,13,Sun,1:00PM,Indianapolis Colts,@,Tennessee Titans,31,28,355,2,381,2,0,3,-26,0,False,True
2023-12-03,13,Sun,1:00PM,Atlanta Falcons,@,New York Jets,13,8,194,0,259,3,0,5,-65,-3,False,True
2023-12-03,13,Sun,1:00PM,Miami Dolphins,@,Washington Commanders,45,15,406,0,245,1,0,30,161,-1,False,True
2023-12-04,13,Mon,8:15PM,Cincinnati Bengals,@,Jacksonville Jaguars,34,31,491,1,376,0,0,3,115,1,False,True
2023-12-07,14,Thu,8:15PM,New England Patriots,@,Pittsburgh Steelers,21,18,303,1,264,1,0,3,39,0,False,True
2023-12-10,14,Sun,4:05PM,Minnesota Vikings,@,Las Vegas Raiders,3,0,231,0,202,3,0,3,29,-3,False,True
2023-12-10,14,Sun,8:20PM,Dallas Cowboys,,Philadelphia Eagles,33,13,394,1,324,3,0,20,70,-2,True,False
2023-12-10,14,Sun,4:25PM,Denver Broncos,@,Los Angeles Chargers,24,7,322,1,283,2,0,17,39,-1,False,True
2023-12-10,14,Sun,4:25PM,Buffalo Bills,@,Kansas City Chiefs,20,17,327,1,346,2,0,3,-19,-1,False,True
2023-12-10,14,Sun,4:05PM,San Francisco 49ers,,Seattle Seahawks,28,16,527,2,324,2,0,12,203,0,True,False
2023-12-10,14,Sun,1:00PM,Baltimore Ravens,,Los Angeles Rams,37,31,449,1,410,0,0,6,39,1,True,False
2023-12-10,14,Sun,1:00PM,Chicago Bears,,Detroit Lions,28,13,336,0,267,3,0,15,69,-3,True,False
2023-12-10,14,Sun,1:00PM,Cleveland Browns,,Jacksonville Jaguars,31,27,389,3,293,4,0,4,96,-1,True,False
2023-12-10,14,Sun,1:00PM,Cincinnati Bengals,,Indianapolis Colts,34,14,385,1,272,2,0,20,113,-1,True,False
2023-12-10,14,Sun,1:00PM,New York Jets,,Houston Texans,30,6,347,1,135,0,0,24,212,1,True,False
2023-12-10,14,Sun,1:00PM,New Orleans Saints,,Carolina Panthers,28,6,207,1,303,2,0,22,-96,-1,True,False
2023-12-10,14,Sun,1:00PM,Tampa Bay Buccaneers,@,Atlanta Falcons,29,25,290,0,434,1,0,4,-144,-1,False,True
2023-12-11,14,Mon,8:15PM,Tennessee Titans,@,Miami Dolphins,28,27,403,3,366,1,0,1,37,2,False,True
2023-12-11,14,Mon,8:15PM,New York Giants,,Green Bay Packers,24,22,367,2,326,3,0,2,41,-1,True,False
2023-12-14,15,Thu,8:15PM,Las Vegas Raiders,,Los Angeles Chargers,63,21,378,0,326,5,0,42,52,-5,True,False
2023-12-16,15,Sat,1:00PM,Cincinnati Bengals,,Minnesota Vikings,27,24,378,1,424,2,0,3,-46,-1,True,False
2023-12-16,15,Sun,4:30PM,Indianapolis Colts,,Pittsburgh Steelers,30,13,372,0,216,3,0,17,156,-3,True,False
2023-12-16,15,Sun,8:15PM,Detroit Lions,,Denver Broncos,42,17,448,0,287,1,0,25,161,-1,True,False
2023-12-17,15,Sun,1:00PM,New Orleans Saints,,New York Giants,24,6,296,0,193,0,0,18,103,0,True,False
2023-12-17,15,Sun,8:20PM,Baltimore Ravens,@,Jacksonville Jaguars,23,7,396,1,333,2,0,16,63,-1,False,True
2023-12-17,15,Sun,4:05PM,Los Angeles Rams,,Washington Commanders,28,20,445,2,297,1,0,8,148,1,True,False
2023-12-17,15,Sun,4:05PM,San Francisco 49ers,@,Arizona Cardinals,45,29,406,0,436,2,0,16,-30,-2,False,True
2023-12-17,15,Sun,4:25PM,Buffalo Bills,,Dallas Cowboys,31,10,351,0,195,1,0,21,156,-1,True,False
2023-12-17,15,Sun,1:00PM,Miami Dolphins,,New York Jets,30,0,290,0,103,4,0,30,187,-4,True,False
2023-12-17,15,Sun,1:00PM,Carolina Panthers,,Atlanta Falcons,9,7,283,0,204,2,0,2,79,-2,True,False
2023-12-17,15,Sun,1:00PM,Houston Texans,@,Tennessee Titans,19,16,340,1,204,1,0,3,136,0,False,True
2023-12-17,15,Sun,1:00PM,Tampa Bay Buccaneers,@,Green Bay Packers,34,20,452,1,321,1,0,14,131,0,False,True
2023-12-17,15,Sun,1:00PM,Cleveland Browns,,Chicago Bears,20,17,377,3,236,3,0,3,141,0,True,False
2023-12-17,15,Mon,1:00PM,Kansas City Chiefs,@,New England Patriots,27,17,326,2,206,1,0,10,120,1,False,True
2023-12-18,15,Sun,8:15PM,Seattle Seahawks,,Philadelphia Eagles,20,17,297,0,321,2,0,3,-24,-2,True,False
2023-12-21,16,Thu,8:15PM,Los Angeles Rams,,New Orleans Saints,30,22,458,0,339,1,0,8,119,-1,True,False
2023-12-23,16,Sat,8:00PM,Buffalo Bills,@,Los Angeles Chargers,24,22,335,3,273,0,0,2,62,3,False,True
2023-12-23,16,Sat,4:30PM,Pittsburgh Steelers,,Cincinnati Bengals,34,11,397,0,368,3,0,23,29,-3,True,False
2023-12-24,16,Sun,8:15PM,New England Patriots,@,Denver Broncos,26,23,289,1,276,2,0,3,13,-1,False,True
2023-12-24,16,Sun,4:25PM,Miami Dolphins,,Dallas Cowboys,22,20,375,0,339,1,0,2,36,-1,True,False
2023-12-24,16,Sun,4:05PM,Tampa Bay Buccaneers,,Jacksonville Jaguars,30,12,335,0,305,4,0,18,30,-4,True,False
2023-12-24,16,Sun,1:00PM,Seattle Seahawks,@,Tennessee Titans,20,17,273,0,287,0,0,3,-14,0,False,True
2023-12-24,16,Sun,1:00PM,New York Jets,,Washington Commanders,30,28,381,2,245,3,0,2,136,-1,True,False
2023-12-24,16,Sun,4:25PM,Chicago Bears,,Arizona Cardinals,27,16,420,1,306,0,0,11,114,1,True,False
2023-12-24,16,Sun,1:00PM,Cleveland Browns,@,Houston Texans,36,22,418,2,250,2,0,14,168,0,False,True
2023-12-24,16,Sun,1:00PM,Green Bay Packers,@,Carolina Panthers,33,30,369,0,394,0,0,3,-25,0,False,True
2023-12-24,16,Sun,1:00PM,Atlanta Falcons,,Indianapolis Colts,29,10,406,0,262,1,0,19,144,-1,True,False
2023-12-24,16,Sun,1:00PM,Detroit Lions,@,Minnesota Vikings,30,24,389,1,390,4,0,6,-1,-3,False,True
2023-12-25,16,Mon,1:00PM,Las Vegas Raiders,@,Kansas City Chiefs,20,14,205,0,308,2,0,6,-103,-2,False,True
2023-12-25,16,Mon,4:30PM,Philadelphia Eagles,,New York Giants,33,25,465,2,292,1,0,8,173,1,True,False
2023-12-25,16,Mon,8:15PM,Baltimore Ravens,@,San Francisco 49ers,33,19,343,0,429,5,0,14,-86,-5,False,True
2023-12-28,17,Thu,8:15PM,Cleveland Browns,,New York Jets,37,20,428,3,360,2,0,17,68,1,True,False
2023-12-30,17,Sat,8:15PM,Dallas Cowboys,,Detroit Lions,20,19,384,2,420,2,0,1,-36,0,True,False
2023-12-31,17,Sun,1:00PM,Los Angeles Rams,@,New York Giants,26,25,391,3,389,1,0,1,2,2,False,True
2023-12-31,17,Sun,1:00PM,San Francisco 49ers,@,Washington Commanders,27,10,408,0,225,2,0,17,183,-2,False,True
2023-12-31,17,Sun,4:25PM,Denver Broncos,,Los Angeles Chargers,16,9,313,0,301,1,0,7,12,-1,True,False
2023-12-31,17,Sun,8:20PM,Green Bay Packers,@,Minnesota Vikings,33,10,470,1,211,2,0,23,259,-1,False,True
2023-12-31,17,Sun,1:00PM,New Orleans Saints,@,Tampa Bay Buccaneers,23,13,310,0,349,4,0,10,-39,-4,False,True
2023-12-31,17,Sun,4:05PM,Pittsburgh Steelers,@,Seattle Seahawks,30,23,468,0,369,1,0,7,99,-1,False,True
2023-12-31,17,Sun,1:00PM,Baltimore Ravens,,Miami Dolphins,56,19,491,1,375,3,0,37,116,-2,True,False
2023-12-31,17,Sun,4:25PM,Kansas City Chiefs,,Cincinnati Bengals,25,17,373,1,263,0,0,8,110,1,True,False
2023-12-31,17,Sun,1:00PM,Arizona Cardinals,@,Philadelphia Eagles,35,31,449,1,275,1,0,4,174,0,False,True
2023-12-31,17,Sun,1:00PM,Indianapolis Colts,,Las Vegas Raiders,23,20,349,0,370,0,0,3,-21,0,True,False
2023-12-31,17,Sun,1:00PM,Jacksonville Jaguars,,Carolina Panthers,26,0,317,0,124,1,0,26,193,-1,True,False
2023-12-31,17,Sun,1:00PM,Buffalo Bills,,New England Patriots,27,21,281,1,294,4,0,6,-13,-3,True,False
2023-12-31,17,Sun,1:00PM,Chicago Bears,,Atlanta Falcons,37,17,432,0,307,4,0,20,125,-4,True,False
2023-12-31,17,Sun,1:00PM,Houston Texans,,Tennessee Titans,26,3,312,0,187,1,0,23,125,-1,True,False
2024-01-06,18,Sat,4:30PM,Pittsburgh Steelers,@,Baltimore Ravens,17,10,289,2,224,2,0,7,65,0,False,True
2024-01-06,18,Sat,8:15PM,Houston Texans,@,Indianapolis Colts,23,19,306,0,360,1,0,4,-54,-1,False,True
2024-01-07,18,Sun,8:20PM,Buffalo Bills,@,Miami Dolphins,21,14,473,3,275,2,0,7,198,1,False,True
2024-01-07,18,Sun,4:25PM,Los Angeles Rams,@,San Francisco 49ers,21,20,258,1,300,1,0,1,-42,0,False,True
2024-01-07,18,Sun,4:25PM,New York Giants,,Philadelphia Eagles,27,10,415,1,299,4,0,17,116,-3,True,False
2024-01-07,18,Sun,4:25PM,Kansas City Chiefs,@,Los Angeles Chargers,13,12,268,1,353,1,0,1,-85,0,False,True
2024-01-07,18,Sun,4:25PM,Las Vegas Raiders,,Denver Broncos,27,14,359,0,286,1,0,13,73,-1,True,False
2024-01-07,18,Sun,4:25PM,Dallas Cowboys,@,Washington Commanders,38,10,440,1,180,3,0,28,260,-2,False,True
2024-01-07,18,Sun,4:25PM,Seattle Seahawks,@,Arizona Cardinals,21,20,327,0,466,0,0,1,-139,0,False,True
2024-01-07,18,Sun,4:25PM,Green Bay Packers,,Chicago Bears,17,9,432,1,192,0,0,8,240,1,True,False
2024-01-07,18,Sun,1:00PM,Tennessee Titans,,Jacksonville Jaguars,28,20,327,1,362,2,0,8,-35,-1,True,False
2024-01-07,18,Sun,1:00PM,Detroit Lions,,Minnesota Vikings,30,20,381,0,448,2,0,10,-67,-2,True,False
2024-01-07,18,Sun,1:00PM,Cincinnati Bengals,,Cleveland Browns,31,14,328,1,244,2,0,17,84,-1,True,False
2024-01-07,18,Sun,1:00PM,Tampa Bay Buccaneers,@,Carolina Panthers,9,0,228,0,199,2,0,9,29,-2,False,True
2024-01-07,18,Sun,1:00PM,New Orleans Saints,,Atlanta Falcons,48,17,400,0,389,3,0,31,11,-3,True,False
2024-01-07,18,Sun,1:00PM,New York Jets,@,New England Patriots,17,3,254,1,119,2,0,14,135,-1,False,True
2024-01-13,WildCard,Sat,4:30PM,Houston Texans,,Cleveland Browns,45,14,356,0,324,2,0,31,32,-2,True,False
2024-01-13,WildCard,Sat,8:10PM,Kansas City Chiefs,,Miami Dolphins,26,7,409,1,264,1,0,19,145,0,True,False
2024-01-14,WildCard,Sun,4:30PM,Green Bay Packers,@,Dallas Cowboys,48,32,415,0,510,2,0,16,-95,-2,False,True
2024-01-14,WildCard,Sun,8:15PM,Detroit Lions,,Los Angeles Rams,24,23,334,0,425,0,0,1,-91,0,True,False
2024-01-15,WildCard,Mon,4:30PM,Buffalo Bills,,Pittsburgh Steelers,31,17,368,0,324,2,0,14,44,-2,True,False
2024-01-15,WildCard,Mon,8:15PM,Tampa Bay Buccaneers,,Philadelphia Eagles,32,9,426,0,276,0,0,23,150,0,True,False
2024-01-20,Division,Sat,8:15PM,San Francisco 49ers,,Green Bay Packers,24,21,356,0,330,2,0,3,26,-2,True,False
2024-01-20,Division,Sat,4:30PM,Baltimore Ravens,,Houston Texans,34,10,352,0,213,0,0,24,139,0,True,False
2024-01-21,Division,Sun,6:30PM,Kansas City Chiefs,@,Buffalo Bills,27,24,361,1,368,0,0,3,-7,1,False,True
2024-01-21,Division,Sun,3:00PM,Detroit Lions,,Tampa Bay Buccaneers,31,23,391,0,408,2,0,8,-17,-2,True,False
2024-01-28,ConfChamp,Sun,3:00PM,Kansas City Chiefs,@,Baltimore Ravens,17,10,319,0,336,3,0,7,-17,-3,False,True
2024-01-28,ConfChamp,Sun,6:30PM,San Francisco 49ers,,Detroit Lions,34,31,413,1,442,1,0,3,-29,0,True,False
2024-02-11,SuperBowl,Sun,6:30PM,Kansas City Chiefs,N,San Francisco 49ers,25,22,455,2,382,2,0,3,73,0,False,False
